"a" = (/turf/unsimulated/wall,/area/space)
"b" = (/turf/snow/gravsnow,/area/coldwar/trucks/lost)
"c" = (/turf/snow/gravsnow,/area/space)
"d" = (/obj/effect/step_trigger/teleporter/random/trucks_ural,/turf/snow/gravsnow,/area/coldwar/trucks/lost)
"e" = (/turf/snow/gravsnow,/area/shuttle/truck/ural/intertim)
"f" = (/turf/snow/gravsnow,/area/coldwar/trucks/m35)

(1,1,1) = {"
aaaaaaaaaaaaaaaaaaaaaaaaaaaaaaaaaaaaaaaaaaaaaaaaaaaaaaaaaaaa
abbbbbbbbbbbbbbbbbbbbbbabbbbbbbbbbbbbbbbbbbbbbbbbaccccccccca
abbbbbdbbbbbbbbbbbbbbbbabbbbbbbbbbbbbbbbbbbbbbbbbaccccccccca
abbbbbdeeeebbbbbbbbbbbbabbbbbbfffffffffffbbbbbbbbaccccccccca
abbbbbdeeeebbbbbbbbbbbbabbbbbbfffffffffffbbbbbbbbaccccccccca
abbbbbdeeeebbbbbbbbbbbbabbbbbbfffffffffffbbbbbbbbaccccccccca
abbbbbdeeeebbbbbbbbbbbbabbbbbbfffffffffffbbbbbbbbaccccccccca
abbbbbdeeeebbbbbbbbbbbbabbbbbbfffffffffffbbbbbbbbaccccccccca
abbbbbdeeeebbbbbbbbbbbbabbbbbbfffffffffffbbbbbbbbaccccccccca
abbbbbdeeeebbbbbbbbbbbbabbbbbbfffffffffffbbbbbbbbaccccccccca
abbbbbdeeeebbbbbbbbbbbbabbbbbbfffffffffffbbbbbbbbaccccccccca
abbbbbdbbbbbbbbbbbbbbbbabbbbbbfffffffffffbbbbbbbbaccccccccca
abbbbbdbbbbbbbbbbbbbbbbabbbbbbfffffffffffbbbbbbbbaccccccccca
abbbbbdbbbbbbbbbbbbbbbbabbbbbbfffffffffffbbbbbbbbaccccccccca
abbbbbdbbbbbbbbbbbbbbbbabbbbbbfffffffffffbbbbbbbbaccccccccca
abbbbbdbbbbbbbbbbbbbbbbabbbbbbfffffffffffbbbbbbbbaccccccccca
abbbbbdbbbbbbbbbbbbbbbbabbbbbbfffffffffffbbbbbbbbaccccccccca
abbbbbdbbbbbbbbbbbbbbbbabbbbbbfffffffffffbbbbbbbbaccccccccca
abbbbbdbbbbbbbbbbbbbbbbabbbbbbfffffffffffbbbbbbbbaccccccccca
abbbbbbbbbbbbbbbbbbbbbbabbbbbbbbbbbbbbbbbbbbbbbbbaccccccccca
abbbbbbbbbbbbbbbbbbbbbbabbbbbbbbbbbbbbbbbbbbbbbbbaccccccccca
abbbbbbbbbbbbbbbbbbbbbbabbbbbbbbbbbbbbbbbbbbbbbbbaccccccccca
abbbbbbbbbbbbbbbbbbbbbbabbbbbbbbbbbbbbbbbbbbbbbbbaccccccccca
aaaaaaaaaaaaaaaaaaaaaaaaaaaaaaaaaaaaaaaaaaaaaaaaaaccccccccca
acccccccccccccccccccccccccccccccccccccccccccccccccccccccccca
acccccccccccccccccccccccccccccccccccccccccccccccccccccccccca
acccccccccccccccccccccccccccccccccccccccccccccccccccccccccca
acccccccccccccccccccccccccccccccccccccccccccccccccccccccccca
acccccccccccccccccccccccccccccccccccccccccccccccccccccccccca
acccccccccccccccccccccccccccccccccccccccccccccccccccccccccca
acccccccccccccccccccccccccccccccccccccccccccccccccccccccccca
acccccccccccccccccccccccccccccccccccccccccccccccccccccccccca
acccccccccccccccccccccccccccccccccccccccccccccccccccccccccca
acccccccccccccccccccccccccccccccccccccccccccccccccccccccccca
acccccccccccccccccccccccccccccccccccccccccccccccccccccccccca
acccccccccccccccccccccccccccccccccccccccccccccccccccccccccca
acccccccccccccccccccccccccccccccccccccccccccccccccccccccccca
acccccccccccccccccccccccccccccccccccccccccccccccccccccccccca
acccccccccccccccccccccccccccccccccccccccccccccccccccccccccca
acccccccccccccccccccccccccccccccccccccccccccccccccccccccccca
acccccccccccccccccccccccccccccccccccccccccccccccccccccccccca
acccccccccccccccccccccccccccccccccccccccccccccccccccccccccca
acccccccccccccccccccccccccccccccccccccccccccccccccccccccccca
acccccccccccccccccccccccccccccccccccccccccccccccccccccccccca
acccccccccccccccccccccccccccccccccccccccccccccccccccccccccca
acccccccccccccccccccccccccccccccccccccccccccccccccccccccccca
acccccccccccccccccccccccccccccccccccccccccccccccccccccccccca
acccccccccccccccccccccccccccccccccccccccccccccccccccccccccca
acccccccccccccccccccccccccccccccccccccccccccccccccccccccccca
aaaaaaaaaaaaaaaaaaaaacccccccccccccccccccccccccccccccccccccca
abbbbbbbbbabbbbbbbbbacccccccccccccccccccccccccccccccccccccca
abbbbbbbbbabbbbbbbbbacccccccccccccccccccccccccccccccccccccca
abbbbbbbbbabbbbbbbbbacccccccccccccccccccccccccccccccccccccca
abbbbbbbbbabbbbbbbbbacccccccccccccccccccccccccccccccccccccca
abbbbbbbbbabbbbbbbbbacccccccccccccccccccccccccccccccccccccca
abbbbbbbbbabbbbbbbbbacccccccccccccccccccccccccccccccccccccca
abbbbbbbbbabbbbbbbbbacccccccccccccccccccccccccccccccccccccca
abbbbbbbbbabbbbbbbbbacccccccccccccccccccccccccccccccccccccca
abbbbbbbbbabbbbbbbbbacccccccccccccccccccccccccccccccccccccca
aaaaaaaaaaaaaaaaaaaaaaaaaaaaaaaaaaaaaaaaaaaaaaaaaaaaaaaaaaaa
"}
