"a" = (/turf/unsimulated/wall,/area/space)
"b" = (/turf/ground/gravsnow/truck/snow,/area/coldwar/trucks/lost)
"c" = (/turf/ground/gravsnow/truck/road/snow_overlay,/area/coldwar/trucks/lost)
"d" = (/turf/ground/gravsnow/truck/road,/area/coldwar/trucks/lost)
"e" = (/turf/ground/gravsnow,/area/coldwar/trucks/lost)
"f" = (/turf/ground/gravsnow,/area/space)
"g" = (/turf/ground/gravsnow,/area/coldwar/trucks/m35)
"h" = (/obj/effect/step_trigger/teleporter/random/trucks_ural,/turf/ground/gravsnow/truck/road,/area/coldwar/trucks/lost)
"i" = (/turf/ground/gravsnow/truck/road,/area/shuttle/truck/ural/intertim)
"j" = (/turf/ground/gravsnow/truck/road,/area/shuttle/truck/ural/intertim2)
"k" = (/turf/ground/gravsnow/truck/road,/area/shuttle/truck/ural/intertim3)
"l" = (/obj/effect/landmark/map_data{height = 4; level = 2},/turf/unsimulated/wall,/area/space)

(1,1,1) = {"
aaaaaaaaaaaaaaaaaaaaaaaaaaaaaaaaaaaaaaaaaaaaaaaaaaaaaaaaaaaa
abbbbbbbcddddddcbbbbbbbaeeeeeeeeeeeeeeeeeeeeeeeeeafffffffffa
abbbbbbbccccccccbbbbbbbaeeeeeeeeeeeeeeeeeeeeeeeeeafffffffffa
abbbbbbbccccccccbbbbbbbaeeeeeegggggggggggeeeeeeeeafffffffffa
abbbbbbbccccccccbbbbbbbaeeeeeegggggggggggeeeeeeeeafffffffffa
abbbbbbbccccccccbbbbbbbaeeeeeegggggggggggeeeeeeeeafffffffffa
abbbbbbbccccccccbbbbbbbaeeeeeegggggggggggeeeeeeeeafffffffffa
abbbbbbbchhhhhhcbbbbbbbaeeeeeegggggggggggeeeeeeeeafffffffffa
abbbbbbbchiiiihcbbbbbbbaeeeeeegggggggggggeeeeeeeeafffffffffa
abbbbbbbchiiiihcbbbbbbbaeeeeeegggggggggggeeeeeeeeafffffffffa
abbbbbbbchiiiihcbbbbbbbaeeeeeegggggggggggeeeeeeeeafffffffffa
abbbbbbbchiiiihcbbbbbbbaeeeeeegggggggggggeeeeeeeeafffffffffa
abbbbbbbchiiiihcbbbbbbbaeeeeeegggggggggggeeeeeeeeafffffffffa
abbbbbbbchiiiihcbbbbbbbaeeeeeegggggggggggeeeeeeeeafffffffffa
abbbbbbbchiiiihcbbbbbbbaeeeeeegggggggggggeeeeeeeeafffffffffa
abbbbbbbchiiiihcbbbbbbbaeeeeeegggggggggggeeeeeeeeafffffffffa
abbbbbbbchiiiihcbbbbbbbaeeeeeegggggggggggeeeeeeeeafffffffffa
abbbbbbbchhhhhhcbbbbbbbaeeeeeegggggggggggeeeeeeeeafffffffffa
abbbbbbbcddddddcbbbbbbbaeeeeeegggggggggggeeeeeeeeafffffffffa
abbbbbbbcddddddcbbbbbbbaeeeeeeeeeeeeeeeeeeeeeeeeeafffffffffa
abbbbbbbcddddddcbbbbbbbaeeeeeeeeeeeeeeeeeeeeeeeeeafffffffffa
abbbbbbbcddddddcbbbbbbbaeeeeeeeeeeeeeeeeeeeeeeeeeafffffffffa
abbbbbbbcddddddcbbbbbbbaeeeeeeeeeeeeeeeeeeeeeeeeeafffffffffa
aaaaaaaaaaaaaaaaaaaaaaaaaaaaaaaaaaaaaaaaaaaaaaaaaafffffffffa
abbbbbbbcddddddcbbbbbbbabbbbbbbcddddddcbbbbbbbfffffffffffffa
abbbbbbbccccccccbbbbbbbabbbbbbbccccccccbbbbbbbfffffffffffffa
abbbbbbbccccccccbbbbbbbabbbbbbbccccccccbbbbbbbfffffffffffffa
abbbbbbbccccccccbbbbbbbabbbbbbbccccccccbbbbbbbfffffffffffffa
abbbbbbbccccccccbbbbbbbabbbbbbbccccccccbbbbbbbfffffffffffffa
abbbbbbbccccccccbbbbbbbabbbbbbbccccccccbbbbbbbfffffffffffffa
abbbbbbbchhhhhhcbbbbbbbabbbbbbbchhhhhhcbbbbbbbfffffffffffffa
abbbbbbbchjjjjhcbbbbbbbabbbbbbbchkkkkhcbbbbbbbfffffffffffffa
abbbbbbbchjjjjhcbbbbbbbabbbbbbbchkkkkhcbbbbbbbfffffffffffffa
abbbbbbbchjjjjhcbbbbbbbabbbbbbbchkkkkhcbbbbbbbfffffffffffffa
abbbbbbbchjjjjhcbbbbbbbabbbbbbbchkkkkhcbbbbbbbfffffffffffffa
abbbbbbbchjjjjhcbbbbbbbabbbbbbbchkkkkhcbbbbbbbfffffffffffffa
abbbbbbbchjjjjhcbbbbbbbabbbbbbbchkkkkhcbbbbbbbfffffffffffffa
abbbbbbbchjjjjhcbbbbbbbabbbbbbbchkkkkhcbbbbbbbfffffffffffffa
abbbbbbbchjjjjhcbbbbbbbabbbbbbbchkkkkhcbbbbbbbfffffffffffffa
abbbbbbbchjjjjhcbbbbbbbabbbbbbbchkkkkhcbbbbbbbfffffffffffffa
abbbbbbbchhhhhhcbbbbbbbabbbbbbbchhhhhhcbbbbbbbfffffffffffffa
abbbbbbbcddddddcbbbbbbbabbbbbbbcddddddcbbbbbbbfffffffffffffa
abbbbbbbcddddddcbbbbbbbabbbbbbbcddddddcbbbbbbbfffffffffffffa
abbbbbbbcddddddcbbbbbbbabbbbbbbcddddddcbbbbbbbfffffffffffffa
abbbbbbbcddddddcbbbbbbbabbbbbbbcddddddcbbbbbbbfffffffffffffa
abbbbbbbcddddddcbbbbbbbabbbbbbbcddddddcbbbbbbbfffffffffffffa
aaaaaaaaaaaaaaaaaaaaaaaafffffffffffffffffffffffffffffffffffa
affffffffffffffffffffffffffffffffffffffffffffffffffffffffffa
affffffffffffffffffffffffffffffffffffffffffffffffffffffffffa
aaaaaaaaaaaaaaaaaaaaaffffffffffffffffffffffffffffffffffffffa
aeeeeeeeeeaeeeeeeeeeaffffffffffffffffffffffffffffffffffffffa
aeeeeeeeeeaeeeeeeeeeaffffffffffffffffffffffffffffffffffffffa
aeeeeeeeeeaeeeeeeeeeaffffffffffffffffffffffffffffffffffffffa
aeeeeeeeeeaeeeeeeeeeaffffffffffffffffffffffffffffffffffffffa
aeeeeeeeeeaeeeeeeeeeaffffffffffffffffffffffffffffffffffffffa
aeeeeeeeeeaeeeeeeeeeaffffffffffffffffffffffffffffffffffffffa
aeeeeeeeeeaeeeeeeeeeaffffffffffffffffffffffffffffffffffffffa
aeeeeeeeeeaeeeeeeeeeaffffffffffffffffffffffffffffffffffffffa
aeeeeeeeeeaeeeeeeeeeaffffffffffffffffffffffffffffffffffffffa
laaaaaaaaaaaaaaaaaaaaaaaaaaaaaaaaaaaaaaaaaaaaaaaaaaaaaaaaaaa
"}
