"a" = (/turf/unsimulated/wall,/area/space)
"b" = (/turf/ground/gravsnow,/area/coldwar/trucks/lost)
"c" = (/turf/simulated/floor/road,/area/coldwar/trucks/lost)
"d" = (/turf/ground/gravsnow,/area/space)
"e" = (/turf/ground/gravsnow,/area/coldwar/trucks/m35)
"f" = (/obj/effect/step_trigger/teleporter/random/trucks_ural,/turf/simulated/floor/road,/area/coldwar/trucks/lost)
"g" = (/turf/simulated/floor/road,/area/shuttle/truck/ural/intertim)
"h" = (/turf/simulated/floor/road,/area/shuttle/truck/ural/intertim2)
"i" = (/turf/simulated/floor/road,/area/shuttle/truck/ural/intertim3)
"j" = (/obj/effect/landmark/map_data{height = 4; level = 2},/turf/unsimulated/wall,/area/space)

(1,1,1) = {"
aaaaaaaaaaaaaaaaaaaaaaaaaaaaaaaaaaaaaaaaaaaaaaaaaaaaaaaaaaaa
abbbbbbbccccccccbbbbbbbabbbbbbbbbbbbbbbbbbbbbbbbbaddddddddda
abbbbbbbccccccccbbbbbbbabbbbbbbbbbbbbbbbbbbbbbbbbaddddddddda
abbbbbbbccccccccbbbbbbbabbbbbbeeeeeeeeeeebbbbbbbbaddddddddda
abbbbbbbccccccccbbbbbbbabbbbbbeeeeeeeeeeebbbbbbbbaddddddddda
abbbbbbbccccccccbbbbbbbabbbbbbeeeeeeeeeeebbbbbbbbaddddddddda
abbbbbbbccccccccbbbbbbbabbbbbbeeeeeeeeeeebbbbbbbbaddddddddda
abbbbbbbcffffffcbbbbbbbabbbbbbeeeeeeeeeeebbbbbbbbaddddddddda
abbbbbbbcfggggfcbbbbbbbabbbbbbeeeeeeeeeeebbbbbbbbaddddddddda
abbbbbbbcfggggfcbbbbbbbabbbbbbeeeeeeeeeeebbbbbbbbaddddddddda
abbbbbbbcfggggfcbbbbbbbabbbbbbeeeeeeeeeeebbbbbbbbaddddddddda
abbbbbbbcfggggfcbbbbbbbabbbbbbeeeeeeeeeeebbbbbbbbaddddddddda
abbbbbbbcfggggfcbbbbbbbabbbbbbeeeeeeeeeeebbbbbbbbaddddddddda
abbbbbbbcfggggfcbbbbbbbabbbbbbeeeeeeeeeeebbbbbbbbaddddddddda
abbbbbbbcfggggfcbbbbbbbabbbbbbeeeeeeeeeeebbbbbbbbaddddddddda
abbbbbbbcfggggfcbbbbbbbabbbbbbeeeeeeeeeeebbbbbbbbaddddddddda
abbbbbbbcfggggfcbbbbbbbabbbbbbeeeeeeeeeeebbbbbbbbaddddddddda
abbbbbbbcffffffcbbbbbbbabbbbbbeeeeeeeeeeebbbbbbbbaddddddddda
abbbbbbbccccccccbbbbbbbabbbbbbeeeeeeeeeeebbbbbbbbaddddddddda
abbbbbbbccccccccbbbbbbbabbbbbbbbbbbbbbbbbbbbbbbbbaddddddddda
abbbbbbbccccccccbbbbbbbabbbbbbbbbbbbbbbbbbbbbbbbbaddddddddda
abbbbbbbccccccccbbbbbbbabbbbbbbbbbbbbbbbbbbbbbbbbaddddddddda
abbbbbbbccccccccbbbbbbbabbbbbbbbbbbbbbbbbbbbbbbbbaddddddddda
aaaaaaaaaaaaaaaaaaaaaaaaaaaaaaaaaaaaaaaaaaaaaaaaaaddddddddda
abbbbbbbccccccccbbbbbbbabbbbbbbccccccccbbbbbbbadddddddddddda
abbbbbbbccccccccbbbbbbbabbbbbbbccccccccbbbbbbbadddddddddddda
abbbbbbbccccccccbbbbbbbabbbbbbbccccccccbbbbbbbadddddddddddda
abbbbbbbccccccccbbbbbbbabbbbbbbccccccccbbbbbbbadddddddddddda
abbbbbbbccccccccbbbbbbbabbbbbbbccccccccbbbbbbbadddddddddddda
abbbbbbbccccccccbbbbbbbabbbbbbbccccccccbbbbbbbadddddddddddda
abbbbbbbcffffffcbbbbbbbabbbbbbbcffffffcbbbbbbbadddddddddddda
abbbbbbbcfhhhhfcbbbbbbbabbbbbbbcfiiiifcbbbbbbbadddddddddddda
abbbbbbbcfhhhhfcbbbbbbbabbbbbbbcfiiiifcbbbbbbbadddddddddddda
abbbbbbbcfhhhhfcbbbbbbbabbbbbbbcfiiiifcbbbbbbbadddddddddddda
abbbbbbbcfhhhhfcbbbbbbbabbbbbbbcfiiiifcbbbbbbbadddddddddddda
abbbbbbbcfhhhhfcbbbbbbbabbbbbbbcfiiiifcbbbbbbbadddddddddddda
abbbbbbbcfhhhhfcbbbbbbbabbbbbbbcfiiiifcbbbbbbbadddddddddddda
abbbbbbbcfhhhhfcbbbbbbbabbbbbbbcfiiiifcbbbbbbbadddddddddddda
abbbbbbbcfhhhhfcbbbbbbbabbbbbbbcfiiiifcbbbbbbbadddddddddddda
abbbbbbbcfhhhhfcbbbbbbbabbbbbbbcfiiiifcbbbbbbbadddddddddddda
abbbbbbbcffffffcbbbbbbbabbbbbbbcffffffcbbbbbbbadddddddddddda
abbbbbbbccccccccbbbbbbbabbbbbbbccccccccbbbbbbbadddddddddddda
abbbbbbbccccccccbbbbbbbabbbbbbbccccccccbbbbbbbadddddddddddda
abbbbbbbccccccccbbbbbbbabbbbbbbccccccccbbbbbbbadddddddddddda
abbbbbbbccccccccbbbbbbbabbbbbbbccccccccbbbbbbbadddddddddddda
abbbbbbbccccccccbbbbbbbabbbbbbbccccccccbbbbbbbadddddddddddda
aaaaaaaaaaaaaaaaaaaaaaaaaaaaaaaaaaaaaaaaaaaaaaadddddddddddda
adddddddddddddddddddddddddddddddddddddddddddddddddddddddddda
adddddddddddddddddddddddddddddddddddddddddddddddddddddddddda
aaaaaaaaaaaaaaaaaaaaadddddddddddddddddddddddddddddddddddddda
abbbbbbbbbabbbbbbbbbadddddddddddddddddddddddddddddddddddddda
abbbbbbbbbabbbbbbbbbadddddddddddddddddddddddddddddddddddddda
abbbbbbbbbabbbbbbbbbadddddddddddddddddddddddddddddddddddddda
abbbbbbbbbabbbbbbbbbadddddddddddddddddddddddddddddddddddddda
abbbbbbbbbabbbbbbbbbadddddddddddddddddddddddddddddddddddddda
abbbbbbbbbabbbbbbbbbadddddddddddddddddddddddddddddddddddddda
abbbbbbbbbabbbbbbbbbadddddddddddddddddddddddddddddddddddddda
abbbbbbbbbabbbbbbbbbadddddddddddddddddddddddddddddddddddddda
abbbbbbbbbabbbbbbbbbadddddddddddddddddddddddddddddddddddddda
jaaaaaaaaaaaaaaaaaaaaaaaaaaaaaaaaaaaaaaaaaaaaaaaaaaaaaaaaaaa
"}
