"a" = (/turf/snow/gravsnow,/area/space)
"b" = (/turf/simulated/floor/pavement,/area/space)
"c" = (/turf/simulated/floor/road,/area/space)
"d" = (/obj/structure/window/fence,/turf/snow/gravsnow,/area/space)
"e" = (/obj/structure/window/fence{dir = 8},/turf/snow/gravsnow,/area/space)
"f" = (/turf/simulated/wall/wood,/area/space)
"g" = (/obj/structure/window/fence{dir = 4},/turf/snow/gravsnow,/area/space)
"h" = (/turf/simulated/floor/wood,/area/space)
"i" = (/obj/structure/barricade,/turf/simulated/floor/wood,/area/space)
"j" = (/obj/structure/bed,/obj/item/weapon/bedsheet,/turf/simulated/floor/wood,/area/space)
"k" = (/obj/structure/bed/chair/wood{dir = 4},/turf/simulated/floor/wood,/area/space)
"l" = (/obj/structure/table/standard,/turf/simulated/floor/wood,/area/space)
"m" = (/obj/structure/bed/chair/wood{dir = 8},/turf/simulated/floor/wood,/area/space)
"n" = (/obj/structure/bed/chair/wood{dir = 1},/turf/simulated/floor/wood,/area/space)
"o" = (/obj/structure/window/fence{dir = 1},/turf/snow/gravsnow,/area/space)
"p" = (/obj/structure/bed,/obj/item/weapon/bedsheet/blue,/turf/simulated/floor/wood,/area/space)
"q" = (/obj/structure/table/standard,/obj/item/weapon/grenade/frag,/turf/simulated/floor/wood,/area/space)
"r" = (/turf/simulated/wall/concrete,/area/space)
"s" = (/obj/structure/table/steel,/turf/simulated/floor/fixed,/area/space)
"t" = (/turf/simulated/floor/fixed,/area/space)
"u" = (/obj/structure/table/steel,/turf/simulated/floor/wood,/area/space)
"v" = (/turf/simulated/floor/holofloor/tiled,/area/space)
"w" = (/obj/machinery/shower,/turf/simulated/floor/holofloor/tiled,/area/space)
"x" = (/obj/structure/toilet{dir = 1},/turf/simulated/floor/holofloor/tiled,/area/space)

(1,1,1) = {"
aaaaaaaaaaaaaaaaaaabaaabaaaaaaaaaaaaaaaaaaaabccccbaaaaaaaaaaaaaaaaaaaa
aaaaaaaaaaaaaaaaaaabcccbaaaaaaaaaaaaaaaaaaaabccccbaaaaaaaaaaaaaaaaaaaa
aaaaaaaaaaaaaaaaaaabcccbaaaaaaaaaaaaaaaaaaaabccccbaaaaaaaaaaaaaaaaaaaa
aaaaaaaaaaaaaaaaaaabcccbaaaaaaaaaaaaaaaaaaaabccccbaaaaaaaaaaaaaaaaaaaa
addddddddddddddddddbcccbaaaaaaaaaaaaaaaaaaaabccccbaaaaaaaaaaaaaaaaaaaa
aefffffaaaaaaaaaaagbcccbaaaaaaaaaaaaaaaaaaaabccccbaaaaaaaaaaaaaaaaaaaa
aefhhhfaaaaaaaaaaagbcccbaaaaaaaaaaaaaaaaaaaabccccbaaaaaaaaaaaaaaaaaaaa
aefhhhfaaaaaaaaaaagbcccbhhhhhhhhhhhhhhhhhhhhbccccbaaaaaaaaaaaaaaaaaaaa
aeffiffaaaaaaaaaaagbcccbhhhhhhhhhhhhhhhhhhhhbccccbahhhhhhhhhhhhhhaaaaa
aeaaaaaaaaaaaaaaaagbcccbhhhhhhhhhhhhhhhhhhhhbccccbahhhhhhhhhhhhhhaaaaa
aeaaaaaaaaaaaaaaaagbcccbhhhhhhhhhhhhhhhhhhhhbccccbahhhhhhhhhhhhhhaaaaa
aefffffffffffffffagbcccbhhhhhhhhhhhhhhhhhhhhbccccbahhhhhhhhhhhhhhaaaaa
aefhjhjfkllmhfhhfagbcccbhhhhhhhhhhhhhhhhhhhhbccccbahhhhhhhhhhhhhhaaaaa
aefhjhjfhnnhhhhhfagbcccbhhhhhhhhhhhhhhhhhhhhbccccbahhhhhhhhhhhhhhaaaaa
aefhhhhhhhhhhfhhfaabcccbhhhhhhhhhhhhhhhhhhhhbccccbahhhhhhhhhhhhhhaaaaa
aefhjhjfhhhhhfhhhbbbcccbhhhhhhhhhhhhhhhhhhhhbccccbahhhhhhhhhhhhhhaaaaa
aefffffffffffffffbgbcccbhhhhhhhhhhhhhhhhhhhhbccccbahhhhhhhhhhhhhhaaaaa
aeaaaaaaaaaaaaaaaagbcccbhhhhhhhhhhhhhhhhhhhhbccccbahhhhhhhhhhhhhhaaaaa
aeaaaaaaaaaaaaaaaagbcccbhhhhhhhhhhhhhhhhhhhhbccccbaaaaaaaaaaaaaaaaaaaa
aeaaaaaaaaaaaaaaaagbcccbhhhhhhhhhhhhhhhhhhhhbccccbaaaaaaaaaaaaaaaaaaaa
aeaaaaaaaaaaaaaaaagbcccbhhhhhhhhhhhhhhhhhhhhbccccbaaaaaaaaaaaaaaaaaaaa
aoooooooooooooooooobcccbhhhhhhhhhhhhhhhhhhhhbccccbahhhhhhhhhhhhhhaaaaa
aeaaaaaaaaaaaaaaaagbcccbhhhhhhhhhhhhhhhhhhhhbccccbahhhhhhhhhhhhhhaaaaa
aeaaaaaaaaaaaaaaaagbcccbhhhhhhhhhhhhhhhhhhhhbccccbahhhhhhhhhhhhhhaaaaa
aeffiffffffffffffagbcccbhhhhhhhhhhhhhhhhhhhhbccccbahhhhhhhhhhhhhhaaaaa
aefhhhfpppfkqmhhfagbcccbhhhhhhhhhhhhhhhhhhhhbccccbahhhhhhhhhhhhhhaaaaa
aefhhhfhhhhhnhhhfagbcccbhhhhhhhhhhhhhhhhhhhhbccccbahhhhhhhhhhhhhhaaaaa
aefhhhfpppfhhhhhhbbbcccbhhhhhhhhhhhhhhhhhhhhbccccbahhhhhhhhhhhhhhaaaaa
aefffffffffffffffagbcccbhhhhhhhhhhhhhhhhhhhhbccccbahhhhhhhhhhhhhhaaaaa
aeaaaaaaaaaaaaaaaagbcccbaaaaaaaaaaaaaaaaaaaabccccbahhhhhhhhhhhhhhaaaaa
adooooooooooooooooobcccbaaaaaaaaaaaaaaaaaaaabccccbahhhhhhhhhhhhhhaaaaa
aeaaaaaaaaaaaaaaaagbcccbaaaaaaaaaaaaaaaaaaaabccccbaaaaaaaaaaaaaaaaaaaa
aeaaaaaaaaaaaaaaaagbcccbbbbbbbbbbbbbbbbbbbbbbccccbaaaaaaaaaaaaaaaaaaaa
aeaaaaaaaaaaaaaaaagbcccbbbbbbbbbbbbbbbbbbbbbbccccbaaaaaaaaaaaaaaaaaaaa
aeaaaaaaaaaaaaaaaagbcccbbbbbbbbbbbbbbbbbbbbbbccccbahhhhhhhhhhhhhhaaaaa
aeffiffffffffffffagbcccbbbbbbbbbbbbbbbbbbbbbbccccbahhhhhhhhhhhhhhaaaaa
aefhhhhfjjjfkllmfagbcccbbbbbbbbbbbbbbbbbbbbbbccccbahhhhhhhhhhhhhhaaaaa
aefhhhhfjhhhhhhhfbbbcccbbbbbbbbbbbbbbbbbbbbbbccccbahhhhhhhhhhhhhhaaaaa
aefhhhhfjjjhhhhhhbbbcccbbbbbbbbbbbbbbbbbbbbbbccccbahhhhhhhhhhhhhhaaaaa
aefffffffffffffffbbbcccbbbbbbbbbbbbbbbbbbbbbbccccbahhhhhhhhhhhhhhaaaaa
aoooooooooooooooooobcccbbbbbbbbbbbbbbbbbbbbbbccccbahhhhhhhhhhhhhhaaaaa
aarrrrrrrrrrrrrrraabcccbbbbbbbbbbbbbbbbbbbbbbccccbahhhhhhhhhhhhhhaaaaa
aarsssssrttttttttaabcccbbbbbbbbbbbbbbbbbbbbbbccccbahhhhhhhhhhhhhhaaaaa
aarsttttrttttttttaabcccbbbbbbbbbbbbbbbbbbbbbbccccbahhhhhhhhhhhhhhaaaaa
aarstttttttttttttaabcccbbbbbbbbbbbbbbbbbbbbbbccccbaaaaaaaaaaaaaaaaaaaa
aarrrrrrrrrrrrrrraabcccbbbbbbbbbbbbbbbbbbbbbbccccbaaaaaaaaaaaaaaaaaaaa
aaaaaaaaaaaaaaaaaaabcccbbbbbbbbbbbbbbbbbbbbbbccccbaaaaaaaaaaaaaaaaaaaa
aaffffffffffffffaaabcccbbbbbbbbbbbbbbbbbbbbbbccccbahhhhhhhhhhhhhhaaaaa
aafhhhhfhhhhfhhfaaabcccbbbbbbbbbbbbbbbbbbbbbbccccbahhhhhhhhhhhhhhaaaaa
aafhhhhfhhhhfhhfaaabcccbbbbbbbbbbbbbbbbbbbbbbccccbahhhhhhhhhhhhhhaaaaa
aaffffiffffiffhfbbbbcccbbbbbbbbbbbbbbbbbbbbbbccccbahhhhhhhhhhhhhhaaaaa
aafhhhhhhhhhhhhhbbbbcccbbbbbbbbbbbbbbbbbbbbbbccccbahhhhhhhhhhhhhhaaaaa
aaffffhffffhfhhfbbbbcccbbbbbbbbbbbbbbbbbbbbbbccccbahhhhhhhhhhhhhhaaaaa
aafjhhhfkumhffffaaabcccbbbbbbbbbbbbbbbbbbbbbbccccbahhhhhhhhhhhhhhaaaaa
aafjhhhfkumhhvwfaaabcccbbbbbbbbbbbbbbbbbbbbbbccccbahhhhhhhhhhhhhhaaaaa
aafjjjjfhhhhfxvfaaabcccbbbbbbbbbbbbbbbbbbbbbbccccbahhhhhhhhhhhhhhaaaaa
aaffffffffffffffaaabcccbbbbbbbbbbbbbbbbbbbbbbccccbahhhhhhhhhhhhhhaaaaa
aaaaaaaaaaaaaaaaaaabcccbbbbbbbbbbbbbbbbbbbbbbccccbaaaaaaaaaaaaaaaaaaaa
aaaaaaaaaaaaaaaaaaabcccbbbbbbbbbbbbbbbbbbbbbbccccbaaaaaaaaaaaaaaaaaaaa
aaaaaaaaaaaaaaaaaaabcccbbbbbbbbbbbbbbbbbbbbbbccccbaaaaaaaaaaaaaaaaaaaa
aaaaaaaaaaaaaaaaaaabcccbbbbbbbbbbbbbbbbbbbbbbccccbaaaaaaaaaaaaaaaaaaaa
aaaaaaaaaaaaaaaaaaabcccbbbbbbbbbbbbbbbbbbbbbbccccbaaaaaaaaaaaaaaaaaaaa
aaaaaaaaaaaaaaaaaaabcccbbbbbbbbbbbbbbbbbbbbbbccccbaaaaaaaaaaaaaaaaaaaa
aaaaaaaaaaaaaaaaaaabcccbbbbbbbbbbbbbbbbbbbbbbccccbaaaaaaaaaaaaaaaaaaaa
bbbbbbbbbbbbbbbbbbbbcccbbbbbbbbbbbbbbbbbbbbbbccccbbbbbbbbbbbbbbbbbbbbb
cccccccccccccccccccccccccccccccccccccccccccccccccccccccccccccccccccccc
cccccccccccccccccccccccccccccccccccccccccccccccccccccccccccccccccccccc
cccccccccccccccccccccccccccccccccccccccccccccccccccccccccccccccccccccc
cccccccccccccccccccccccccccccccccccccccccccccccccccccccccccccccccccccc
bbbbbbbbbbbbbbbbbbbbbbbbbbbbbbbbbbbbbbbbbbbbbbbbbbbbbbbbbbbbbbbbbbbbbb
"}
