"a" = (/turf/snow/gravsnow,/area/space)
"b" = (/turf/simulated/floor/wood,/area/space)
"c" = (/turf/simulated/wall/concrete,/area/space)
"d" = (/turf/simulated/floor/fixed,/area/space)
"e" = (/turf/simulated/wall/wood,/area/space)
"f" = (/obj/effect/expl_particles,/turf/simulated/floor/wood,/area/space)
"g" = (/obj/structure/barricade,/turf/simulated/floor/wood,/area/space)
"h" = (/obj/structure/bed/chair/wood,/turf/simulated/floor/wood,/area/space)
"i" = (/turf/simulated/floor/holofloor/tiled,/area/space)
"j" = (/obj/machinery/shower,/turf/simulated/floor/holofloor/tiled,/area/space)
"k" = (/obj/structure/bed,/turf/simulated/floor/wood,/area/space)
"l" = (/obj/structure/toilet{dir = 1},/turf/simulated/floor/holofloor/tiled,/area/space)

(1,1,1) = {"
aaaaaaaaaaaaaaaaaaaaaaaaaaaaaaaaaaaaaaaaaaaaaaaaaaaaaaaaaaaaaaaaaaaaaa
aaaaaaaaaaaaaaaaaaaaaaaaaaaaaaaaaaaaaaaaaaaaaaaaaaaaaaaaaaaaaaaaaaaaaa
aaaaaaaaaaaaaaaaaaaaaaaaaaaaaaaaaaaaaaaaaaaaaaaaaaaaaaaaaaaaaaaaaaaaaa
aaaaaaaaaaaaaaaaaaaaaaaaaaaaaaaaaaaaaaaaaaaaaaaaaaaaaaaaaaaaaaaaaaaaaa
aaaaaaaaaaaaaaaaaaaaaaaaaaaaaaaaaaaaaaaaaaaaaaaaaaaaaaaaaaaaaaaaaaaaaa
aaaaaaaaaaaaaaaaaaaaaaaaaaaaaaaaaaaaaaaaaaaaaaaaaaaaaaaaaaaaaaaaaaaaaa
aaaaaaaaaaaaaaaaaaaaaaaaaaaaaaaaaaaaaaaaaaaaaaaaaaaaaaaaaaaaaaaaaaaaaa
aabbbbbbbbbbbbbbbaaaaaaabbbbbbbbbbbbbbbbbbbbaaaaaaaaaaaaaaaaaaaaaaaaaa
aabbbbbbbbbbbbbbbaaaaaaabbbbbbbbbbbbbbbbbbbbaaaaaaabbbbbbbbbbbbbbaaaaa
aabbbbbbbbbbbbbbbaaaaaaabbbbbbbbbbbbbbbbbbbbaaaaaaabbbbbbbbbbbbbbaaaaa
aabbbbbbbbbbbbbbbaaaaaaabbbbbbbbbbbbbbbbbbbbaaaaaaabbbbbbbbbbbbbbaaaaa
aabbbbbbbbbbbbbbbaaaaaaabbbbbbbbbbbbbbbbbbbbaaaaaaabbbbbbbbbbbbbbaaaaa
aabbbbbbbbbbbbbbbaaaaaaabbbbbbbbbbbbbbbbbbbbaaaaaaabbbbbbbbbbbbbbaaaaa
aabbbbbbbbbbbbbbbaaaaaaabbbbbbbbbbbbbbbbbbbbaaaaaaabbbbbbbbbbbbbbaaaaa
aabbbbbbbbbbbbbbbaaaaaaabbbbbbbbbbbbbbbbbbbbaaaaaaabbbbbbbbbbbbbbaaaaa
aabbbbbbbbbbbbbbbaaaaaaabbbbbbbbbbbbbbbbbbbbaaaaaaabbbbbbbbbbbbbbaaaaa
aabbbbbbbbbbbbbbbaaaaaaabbbbbbbbbbbbbbbbbbbbaaaaaaabbbbbbbbbbbbbbaaaaa
aaaaaaaaaaaaaaaaaaaaaaaabbbbbbbbbbbbbbbbbbbbaaaaaaabbbbbbbbbbbbbbaaaaa
aaaaaaaaaaaaaaaaaaaaaaaabbbbbbbbbbbbbbbbbbbbaaaaaaaaaaaaaaaaaaaaaaaaaa
aabbbbbbbbbbbbbbbaaaaaaabbbbbbbbbbbbbbbbbbbbaaaaaaaaaaaaaaaaaaaaaaaaaa
aabbbbbbbbbbbbbbbaaaaaaabbbbbbbbbbbbbbbbbbbbaaaaaaaaaaaaaaaaaaaaaaaaaa
aabbbbbbbbbbbbbbbaaaaaaabbbbbbbbbbbbbbbbbbbbaaaaaaabbbbbbbbbbbbbbaaaaa
aabbbbbbbbbbbbbbbaaaaaaabbbbbbbbbbbbbbbbbbbbaaaaaaabbbbbbbbbbbbbbaaaaa
aabbbbbbbbbbbbbbbaaaaaaabbbbbbbbbbbbbbbbbbbbaaaaaaabbbbbbbbbbbbbbaaaaa
aabbbbbbbbbbbbbbbaaaaaaabbbbbbbbbbbbbbbbbbbbaaaaaaabbbbbbbbbbbbbbaaaaa
aabbbbbbbbbbbbbbbaaaaaaabbbbbbbbbbbbbbbbbbbbaaaaaaabbbbbbbbbbbbbbaaaaa
aabbbbbbbbbbbbbbbaaaaaaabbbbbbbbbbbbbbbbbbbbaaaaaaabbbbbbbbbbbbbbaaaaa
aabbbbbbbbbbbbbbbaaaaaaabbbbbbbbbbbbbbbbbbbbaaaaaaabbbbbbbbbbbbbbaaaaa
aabbbbbbbbbbbbbbbaaaaaaabbbbbbbbbbbbbbbbbbbbaaaaaaabbbbbbbbbbbbbbaaaaa
aaaaaaaaaaaaaaaaaaaaaaaaaaaaaaaaaaaaaaaaaaaaaaaaaaabbbbbbbbbbbbbbaaaaa
aaaaaaaaaaaaaaaaaaaaaaaaaaaaaaaaaaaaaaaaaaaaaaaaaaabbbbbbbbbbbbbbaaaaa
aabbbbbbbbbbbbbbbaaaaaaaaaaaaaaaaaaaaaaaaaaaaaaaaaaaaaaaaaaaaaaaaaaaaa
aabbbbbbbbbbbbbbbaaaaaaaaaaaaaaaaaaaaaaaaaaaaaaaaaaaaaaaaaaaaaaaaaaaaa
aabbbbbbbbbbbbbbbaaaaaaaaaaaaaaaaaaaaaaaaaaaaaaaaaaaaaaaaaaaaaaaaaaaaa
aabbbbbbbbbbbbbbbaaaaaaaaaaaaaaaaaaaaaaaaaaaaaaaaaabbbbbbbbbbbbbbaaaaa
aabbbbbbbbbbbbbbbaaaaaaaaaaaaaaaaaaaaaaaaaaaaaaaaaabbbbbbbbbbbbbbaaaaa
aabbbbbbbbbbbbbbbaaaaaaaaaaaaaaaaaaaaaaaaaaaaaaaaaabbbbbbbbbbbbbbaaaaa
aabbbbbbbbbbbbbbbaaaaaaaaaaaaaaaaaaaaaaaaaaaaaaaaaabbbbbbbbbbbbbbaaaaa
aabbbbbbbbbbbbbbbaaaaaaaaaaaaaaaaaaaaaaaaaaaaaaaaaabbbbbbbbbbbbbbaaaaa
aabbbbbbbbbbbbbbbaaaaaaaaaaaaaaaaaaaaaaaaaaaaaaaaaabbbbbbbbbbbbbbaaaaa
aaaaaaaaaaaaaaaaaaaaaaaaaaaaaaaaaaaaaaaaaaaaaaaaaaabbbbbbbbbbbbbbaaaaa
aacccccccccccccccaaaaaaaaaaaaaaaaaaaaaaaaaaaaaaaaaabbbbbbbbbbbbbbaaaaa
aacdddddcddddddddaaaaaaaaaaaaaaaaaaaaaaaaaaaaaaaaaabbbbbbbbbbbbbbaaaaa
aacdddddcddddddddaaaaaaaaaaaaaaaaaaaaaaaaaaaaaaaaaabbbbbbbbbbbbbbaaaaa
aacddddddddddddddaaaaaaaaaaaaaaaaaaaaaaaaaaaaaaaaaaaaaaaaaaaaaaaaaaaaa
aacccccccccccccccaaaaaaaaaaaaaaaaaaaaaaaaaaaaaaaaaaaaaaaaaaaaaaaaaaaaa
aaaaaaaaaaaaaaaaaaaaaaaaaaaaaaaaaaaaaaaaaaaaaaaaaaaaaaaaaaaaaaaaaaaaaa
aaeeeeeeeeeeeeeeaaaaaaaaaaaaaaaaaaaaaaaaaaaaaaaaaaabbbbbbbbbbbbbbaaaaa
aaefffbebbbbebbeaaaaaaaaaaaaaaaaaaaaaaaaaaaaaaaaaaabbbbbbbbbbbbbbaaaaa
aaefffbebbbbebbeaaaaaaaaaaaaaaaaaaaaaaaaaaaaaaaaaaabbbbbbbbbbbbbbaaaaa
aaeeeegeeeebeebeaaaaaaaaaaaaaaaaaaaaaaaaaaaaaaaaaaabbbbbbbbbbbbbbaaaaa
aaebbbbbbbbbbbbbaaaaaaaaaaaaaaaaaaaaaaaaaaaaaaaaaaabbbbbbbbbbbbbbaaaaa
aaeeeebeeeebebbeaaaaaaaaaaaaaaaaaaaaaaaaaaaaaaaaaaabbbbbbbbbbbbbbaaaaa
aaebbbbehbhbeeeeaaaaaaaaaaaaaaaaaaaaaaaaaaaaaaaaaaabbbbbbbbbbbbbbaaaaa
aaebbbbehbhbbijeaaaaaaaaaaaaaaaaaaaaaaaaaaaaaaaaaaabbbbbbbbbbbbbbaaaaa
aaekbkbebbbbelieaaaaaaaaaaaaaaaaaaaaaaaaaaaaaaaaaaabbbbbbbbbbbbbbaaaaa
aaeeeeeeeeeeeeeeaaaaaaaaaaaaaaaaaaaaaaaaaaaaaaaaaaabbbbbbbbbbbbbbaaaaa
aaaaaaaaaaaaaaaaaaaaaaaaaaaaaaaaaaaaaaaaaaaaaaaaaaaaaaaaaaaaaaaaaaaaaa
aaaaaaaaaaaaaaaaaaaaaaaaaaaaaaaaaaaaaaaaaaaaaaaaaaaaaaaaaaaaaaaaaaaaaa
aaaaaaaaaaaaaaaaaaaaaaaaaaaaaaaaaaaaaaaaaaaaaaaaaaaaaaaaaaaaaaaaaaaaaa
aaaaaaaaaaaaaaaaaaaaaaaaaaaaaaaaaaaaaaaaaaaaaaaaaaaaaaaaaaaaaaaaaaaaaa
aaaaaaaaaaaaaaaaaaaaaaaaaaaaaaaaaaaaaaaaaaaaaaaaaaaaaaaaaaaaaaaaaaaaaa
aaaaaaaaaaaaaaaaaaaaaaaaaaaaaaaaaaaaaaaaaaaaaaaaaaaaaaaaaaaaaaaaaaaaaa
aaaaaaaaaaaaaaaaaaaaaaaaaaaaaaaaaaaaaaaaaaaaaaaaaaaaaaaaaaaaaaaaaaaaaa
aaaaaaaaaaaaaaaaaaaaaaaaaaaaaaaaaaaaaaaaaaaaaaaaaaaaaaaaaaaaaaaaaaaaaa
aaaaaaaaaaaaaaaaaaaaaaaaaaaaaaaaaaaaaaaaaaaaaaaaaaaaaaaaaaaaaaaaaaaaaa
aaaaaaaaaaaaaaaaaaaaaaaaaaaaaaaaaaaaaaaaaaaaaaaaaaaaaaaaaaaaaaaaaaaaaa
aaaaaaaaaaaaaaaaaaaaaaaaaaaaaaaaaaaaaaaaaaaaaaaaaaaaaaaaaaaaaaaaaaaaaa
aaaaaaaaaaaaaaaaaaaaaaaaaaaaaaaaaaaaaaaaaaaaaaaaaaaaaaaaaaaaaaaaaaaaaa
aaaaaaaaaaaaaaaaaaaaaaaaaaaaaaaaaaaaaaaaaaaaaaaaaaaaaaaaaaaaaaaaaaaaaa
"}
