"a" = (/turf/snow/gravsnow,/area/space)
"b" = (/turf/simulated/floor/road,/area/space)
"c" = (/obj/structure/window/fence,/turf/snow/gravsnow,/area/space)
"d" = (/obj/structure/window/fence{dir = 8},/turf/snow/gravsnow,/area/space)
"e" = (/turf/simulated/wall/wood,/area/space)
"f" = (/obj/structure/window/fence{dir = 4},/turf/snow/gravsnow,/area/space)
"g" = (/turf/simulated/floor/wood,/area/space)
"h" = (/obj/structure/window/fence{dir = 1},/turf/snow/gravsnow,/area/space)
"i" = (/turf/simulated/wall/concrete,/area/space)
"j" = (/obj/structure/table/steel,/turf/simulated/floor/fixed,/area/space)
"k" = (/turf/simulated/floor/fixed,/area/space)
"l" = (/obj/structure/barricade,/turf/simulated/floor/wood,/area/space)
"m" = (/obj/structure/bed/chair/wood{dir = 4},/turf/simulated/floor/wood,/area/space)
"n" = (/obj/structure/table/steel,/turf/simulated/floor/wood,/area/space)
"o" = (/obj/structure/bed/chair/wood{dir = 8},/turf/simulated/floor/wood,/area/space)
"p" = (/turf/simulated/floor/holofloor/tiled,/area/space)
"q" = (/obj/machinery/shower,/turf/simulated/floor/holofloor/tiled,/area/space)
"r" = (/obj/structure/bed,/turf/simulated/floor/wood,/area/space)
"s" = (/obj/structure/toilet{dir = 1},/turf/simulated/floor/holofloor/tiled,/area/space)

(1,1,1) = {"
aaaaaaaaaaaaaaaaaaaaaaaaaaaaaaaaaaaaaaaaaaaaabbbbaaaaaaaaaaaaaaaaaaaaa
aaaaaaaaaaaaaaaaaaaabbbaaaaaaaaaaaaaaaaaaaaaabbbbaaaaaaaaaaaaaaaaaaaaa
aaaaaaaaaaaaaaaaaaaabbbaaaaaaaaaaaaaaaaaaaaaabbbbaaaaaaaaaaaaaaaaaaaaa
aaaaaaaaaaaaaaaaaaaabbbaaaaaaaaaaaaaaaaaaaaaabbbbaaaaaaaaaaaaaaaaaaaaa
accccccccccccccccccabbbaaaaaaaaaaaaaaaaaaaaaabbbbaaaaaaaaaaaaaaaaaaaaa
adeeeeeaaaaaaaaaaafabbbaaaaaaaaaaaaaaaaaaaaaabbbbaaaaaaaaaaaaaaaaaaaaa
adegggeaaaaaaaaaaafabbbaaaaaaaaaaaaaaaaaaaaaabbbbaaaaaaaaaaaaaaaaaaaaa
adegggeaaaaaaaaaaafabbbaggggggggggggggggggggabbbbaaaaaaaaaaaaaaaaaaaaa
adeegeeaaaaaaaaaaafabbbaggggggggggggggggggggabbbbaaggggggggggggggaaaaa
adaaaaaaaaaaaaaaaafabbbaggggggggggggggggggggabbbbaaggggggggggggggaaaaa
adaaaaaaaaaaaaaaaafabbbaggggggggggggggggggggabbbbaaggggggggggggggaaaaa
adeeeeeeeeeeeeeeeafabbbaggggggggggggggggggggabbbbaaggggggggggggggaaaaa
adeggggegggggeggeafabbbaggggggggggggggggggggabbbbaaggggggggggggggaaaaa
adeggggeggggggggeafabbbaggggggggggggggggggggabbbbaaggggggggggggggaaaaa
adeggggggggggeggeaaabbbaggggggggggggggggggggabbbbaaggggggggggggggaaaaa
adeggggegggggegggaaabbbaggggggggggggggggggggabbbbaaggggggggggggggaaaaa
adeeeeeeeeeeeeeeeafabbbaggggggggggggggggggggabbbbaaggggggggggggggaaaaa
adaaaaaaaaaaaaaaaafabbbaggggggggggggggggggggabbbbaaggggggggggggggaaaaa
adaaaaaaaaaaaaaaaafabbbaggggggggggggggggggggabbbbaaaaaaaaaaaaaaaaaaaaa
adaaaaaaaaaaaaaaaafabbbaggggggggggggggggggggabbbbaaaaaaaaaaaaaaaaaaaaa
adaaaaaaaaaaaaaaaafabbbaggggggggggggggggggggabbbbaaaaaaaaaaaaaaaaaaaaa
ahhhhhhhhhhhhhhhhhhabbbaggggggggggggggggggggabbbbaaggggggggggggggaaaaa
adaaaaaaaaaaaaaaaafabbbaggggggggggggggggggggabbbbaaggggggggggggggaaaaa
adaaaaaaaaaaaaaaaafabbbaggggggggggggggggggggabbbbaaggggggggggggggaaaaa
adeegeeeeeeeeeeeeafabbbaggggggggggggggggggggabbbbaaggggggggggggggaaaaa
adegggegggegggggeafabbbaggggggggggggggggggggabbbbaaggggggggggggggaaaaa
adegggegggggggggeafabbbaggggggggggggggggggggabbbbaaggggggggggggggaaaaa
adegggegggeggggggaaabbbaggggggggggggggggggggabbbbaaggggggggggggggaaaaa
adeeeeeeeeeeeeeeeafabbbaggggggggggggggggggggabbbbaaggggggggggggggaaaaa
adaaaaaaaaaaaaaaaafabbbaaaaaaaaaaaaaaaaaaaaaabbbbaaggggggggggggggaaaaa
achhhhhhhhhhhhhhhhhabbbaaaaaaaaaaaaaaaaaaaaaabbbbaaggggggggggggggaaaaa
adaaaaaaaaaaaaaaaafabbbaaaaaaaaaaaaaaaaaaaaaabbbbaaaaaaaaaaaaaaaaaaaaa
adaaaaaaaaaaaaaaaafabbbaaaaaaaaaaaaaaaaaaaaaabbbbaaaaaaaaaaaaaaaaaaaaa
adaaaaaaaaaaaaaaaafabbbaaaaaaaaaaaaaaaaaaaaaabbbbaaaaaaaaaaaaaaaaaaaaa
adaaaaaaaaaaaaaaaafabbbaaaaaaaaaaaaaaaaaaaaaabbbbaaggggggggggggggaaaaa
adeegeeeeeeeeeeeeafabbbaaaaaaaaaaaaaaaaaaaaaabbbbaaggggggggggggggaaaaa
adeggggegggeggggeafabbbaaaaaaaaaaaaaaaaaaaaaabbbbaaggggggggggggggaaaaa
adeggggeggggggggeaaabbbaaaaaaaaaaaaaaaaaaaaaabbbbaaggggggggggggggaaaaa
adeggggegggggggggaaabbbaaaaaaaaaaaaaaaaaaaaaabbbbaaggggggggggggggaaaaa
adeeeeeeeeeeeeeeeaaabbbaaaaaaaaaaaaaaaaaaaaaabbbbaaggggggggggggggaaaaa
ahhhhhhhhhhhhhhhhhhabbbaaaaaaaaaaaaaaaaaaaaaabbbbaaggggggggggggggaaaaa
aaiiiiiiiiiiiiiiiaaabbbaaaaaaaaaaaaaaaaaaaaaabbbbaaggggggggggggggaaaaa
aaijjjjjikkkkkkkkaaabbbaaaaaaaaaaaaaaaaaaaaaabbbbaaggggggggggggggaaaaa
aaijkkkkikkkkkkkkaaabbbaaaaaaaaaaaaaaaaaaaaaabbbbaaggggggggggggggaaaaa
aaijkkkkkkkkkkkkkaaabbbaaaaaaaaaaaaaaaaaaaaaabbbbaaaaaaaaaaaaaaaaaaaaa
aaiiiiiiiiiiiiiiiaaabbbaaaaaaaaaaaaaaaaaaaaaabbbbaaaaaaaaaaaaaaaaaaaaa
aaaaaaaaaaaaaaaaaaaabbbaaaaaaaaaaaaaaaaaaaaaabbbbaaaaaaaaaaaaaaaaaaaaa
aaeeeeeeeeeeeeeeaaaabbbaaaaaaaaaaaaaaaaaaaaaabbbbaaggggggggggggggaaaaa
aaeggggeggggeggeaaaabbbaaaaaaaaaaaaaaaaaaaaaabbbbaaggggggggggggggaaaaa
aaeggggeggggeggeaaaabbbaaaaaaaaaaaaaaaaaaaaaabbbbaaggggggggggggggaaaaa
aaeeeeleeeegeegeaaaabbbaaaaaaaaaaaaaaaaaaaaaabbbbaaggggggggggggggaaaaa
aaegggggggggggggaaaabbbaaaaaaaaaaaaaaaaaaaaaabbbbaaggggggggggggggaaaaa
aaeeeegeeeegeggeaaaabbbaaaaaaaaaaaaaaaaaaaaaabbbbaaggggggggggggggaaaaa
aaeggggemnogeeeeaaaabbbaaaaaaaaaaaaaaaaaaaaaabbbbaaggggggggggggggaaaaa
aaeggggemnoggpqeaaaabbbaaaaaaaaaaaaaaaaaaaaaabbbbaaggggggggggggggaaaaa
aaergrgeggggespeaaaabbbaaaaaaaaaaaaaaaaaaaaaabbbbaaggggggggggggggaaaaa
aaeeeeeeeeeeeeeeaaaabbbaaaaaaaaaaaaaaaaaaaaaabbbbaaggggggggggggggaaaaa
aaaaaaaaaaaaaaaaaaaabbbaaaaaaaaaaaaaaaaaaaaaabbbbaaaaaaaaaaaaaaaaaaaaa
aaaaaaaaaaaaaaaaaaaabbbaaaaaaaaaaaaaaaaaaaaaabbbbaaaaaaaaaaaaaaaaaaaaa
aaaaaaaaaaaaaaaaaaaabbbaaaaaaaaaaaaaaaaaaaaaabbbbaaaaaaaaaaaaaaaaaaaaa
aaaaaaaaaaaaaaaaaaaabbbaaaaaaaaaaaaaaaaaaaaaabbbbaaaaaaaaaaaaaaaaaaaaa
aaaaaaaaaaaaaaaaaaaabbbaaaaaaaaaaaaaaaaaaaaaabbbbaaaaaaaaaaaaaaaaaaaaa
aaaaaaaaaaaaaaaaaaaabbbaaaaaaaaaaaaaaaaaaaaaabbbbaaaaaaaaaaaaaaaaaaaaa
aaaaaaaaaaaaaaaaaaaabbbaaaaaaaaaaaaaaaaaaaaaabbbbaaaaaaaaaaaaaaaaaaaaa
aaaaaaaaaaaaaaaaaaaabbbaaaaaaaaaaaaaaaaaaaaaabbbbaaaaaaaaaaaaaaaaaaaaa
bbbbbbbbbbbbbbbbbbbbbbbbbbbbbbbbbbbbbbbbbbbbbbbbbbbbbbbbbbbbbbbbbbbbbb
bbbbbbbbbbbbbbbbbbbbbbbbbbbbbbbbbbbbbbbbbbbbbbbbbbbbbbbbbbbbbbbbbbbbbb
bbbbbbbbbbbbbbbbbbbbbbbbbbbbbbbbbbbbbbbbbbbbbbbbbbbbbbbbbbbbbbbbbbbbbb
bbbbbbbbbbbbbbbbbbbbbbbbbbbbbbbbbbbbbbbbbbbbbbbbbbbbbbbbbbbbbbbbbbbbbb
aaaaaaaaaaaaaaaaaaaaaaaaaaaaaaaaaaaaaaaaaaaaaaaaaaaaaaaaaaaaaaaaaaaaaa
"}
