"a" = (/turf/snow/gravsnow,/area/space)
"b" = (/obj/structure/window/fence,/turf/snow/gravsnow,/area/space)
"c" = (/obj/structure/window/fence{dir = 8},/turf/snow/gravsnow,/area/space)
"d" = (/turf/simulated/wall/wood,/area/space)
"e" = (/obj/structure/window/fence{dir = 4},/turf/snow/gravsnow,/area/space)
"f" = (/turf/simulated/floor/wood,/area/space)
"g" = (/obj/structure/window/fence{dir = 1},/turf/snow/gravsnow,/area/space)
"h" = (/turf/simulated/wall/concrete,/area/space)
"i" = (/obj/structure/table/steel,/turf/simulated/floor/fixed,/area/space)
"j" = (/turf/simulated/floor/fixed,/area/space)
"k" = (/obj/structure/barricade,/turf/simulated/floor/wood,/area/space)
"l" = (/obj/structure/bed/chair/wood{dir = 4},/turf/simulated/floor/wood,/area/space)
"m" = (/obj/structure/table/steel,/turf/simulated/floor/wood,/area/space)
"n" = (/obj/structure/bed/chair/wood{dir = 8},/turf/simulated/floor/wood,/area/space)
"o" = (/turf/simulated/floor/holofloor/tiled,/area/space)
"p" = (/obj/machinery/shower,/turf/simulated/floor/holofloor/tiled,/area/space)
"q" = (/obj/structure/bed,/turf/simulated/floor/wood,/area/space)
"r" = (/obj/structure/toilet{dir = 1},/turf/simulated/floor/holofloor/tiled,/area/space)

(1,1,1) = {"
aaaaaaaaaaaaaaaaaaaaaaaaaaaaaaaaaaaaaaaaaaaaaaaaaaaaaaaaaaaaaaaaaaaaaa
aaaaaaaaaaaaaaaaaaaaaaaaaaaaaaaaaaaaaaaaaaaaaaaaaaaaaaaaaaaaaaaaaaaaaa
aaaaaaaaaaaaaaaaaaaaaaaaaaaaaaaaaaaaaaaaaaaaaaaaaaaaaaaaaaaaaaaaaaaaaa
aaaaaaaaaaaaaaaaaaaaaaaaaaaaaaaaaaaaaaaaaaaaaaaaaaaaaaaaaaaaaaaaaaaaaa
abbbbbbbbbbbbbbbbbbaaaaaaaaaaaaaaaaaaaaaaaaaaaaaaaaaaaaaaaaaaaaaaaaaaa
acdddddaaaaaaaaaaaeaaaaaaaaaaaaaaaaaaaaaaaaaaaaaaaaaaaaaaaaaaaaaaaaaaa
acdfffdaaaaaaaaaaaeaaaaaaaaaaaaaaaaaaaaaaaaaaaaaaaaaaaaaaaaaaaaaaaaaaa
acdfffdaaaaaaaaaaaeaaaaaffffffffffffffffffffaaaaaaaaaaaaaaaaaaaaaaaaaa
acddfddaaaaaaaaaaaeaaaaaffffffffffffffffffffaaaaaaaffffffffffffffaaaaa
acaaaaaaaaaaaaaaaaeaaaaaffffffffffffffffffffaaaaaaaffffffffffffffaaaaa
acaaaaaaaaaaaaaaaaeaaaaaffffffffffffffffffffaaaaaaaffffffffffffffaaaaa
acdddddddddddddddaeaaaaaffffffffffffffffffffaaaaaaaffffffffffffffaaaaa
acdffffdfffffdffdaeaaaaaffffffffffffffffffffaaaaaaaffffffffffffffaaaaa
acdffffdffffffffdaeaaaaaffffffffffffffffffffaaaaaaaffffffffffffffaaaaa
acdffffffffffdffdaaaaaaaffffffffffffffffffffaaaaaaaffffffffffffffaaaaa
acdffffdfffffdfffaaaaaaaffffffffffffffffffffaaaaaaaffffffffffffffaaaaa
acdddddddddddddddaeaaaaaffffffffffffffffffffaaaaaaaffffffffffffffaaaaa
acaaaaaaaaaaaaaaaaeaaaaaffffffffffffffffffffaaaaaaaffffffffffffffaaaaa
acaaaaaaaaaaaaaaaaeaaaaaffffffffffffffffffffaaaaaaaaaaaaaaaaaaaaaaaaaa
acaaaaaaaaaaaaaaaaeaaaaaffffffffffffffffffffaaaaaaaaaaaaaaaaaaaaaaaaaa
acaaaaaaaaaaaaaaaaeaaaaaffffffffffffffffffffaaaaaaaaaaaaaaaaaaaaaaaaaa
aggggggggggggggggggaaaaaffffffffffffffffffffaaaaaaaffffffffffffffaaaaa
acaaaaaaaaaaaaaaaaeaaaaaffffffffffffffffffffaaaaaaaffffffffffffffaaaaa
acaaaaaaaaaaaaaaaaeaaaaaffffffffffffffffffffaaaaaaaffffffffffffffaaaaa
acddfddddddddddddaeaaaaaffffffffffffffffffffaaaaaaaffffffffffffffaaaaa
acdfffdfffdfffffdaeaaaaaffffffffffffffffffffaaaaaaaffffffffffffffaaaaa
acdfffdfffffffffdaeaaaaaffffffffffffffffffffaaaaaaaffffffffffffffaaaaa
acdfffdfffdffffffaaaaaaaffffffffffffffffffffaaaaaaaffffffffffffffaaaaa
acdddddddddddddddaeaaaaaffffffffffffffffffffaaaaaaaffffffffffffffaaaaa
acaaaaaaaaaaaaaaaaeaaaaaaaaaaaaaaaaaaaaaaaaaaaaaaaaffffffffffffffaaaaa
abgggggggggggggggggaaaaaaaaaaaaaaaaaaaaaaaaaaaaaaaaffffffffffffffaaaaa
acaaaaaaaaaaaaaaaaeaaaaaaaaaaaaaaaaaaaaaaaaaaaaaaaaaaaaaaaaaaaaaaaaaaa
acaaaaaaaaaaaaaaaaeaaaaaaaaaaaaaaaaaaaaaaaaaaaaaaaaaaaaaaaaaaaaaaaaaaa
acaaaaaaaaaaaaaaaaeaaaaaaaaaaaaaaaaaaaaaaaaaaaaaaaaaaaaaaaaaaaaaaaaaaa
acaaaaaaaaaaaaaaaaeaaaaaaaaaaaaaaaaaaaaaaaaaaaaaaaaffffffffffffffaaaaa
acddfddddddddddddaeaaaaaaaaaaaaaaaaaaaaaaaaaaaaaaaaffffffffffffffaaaaa
acdffffdfffdffffdaeaaaaaaaaaaaaaaaaaaaaaaaaaaaaaaaaffffffffffffffaaaaa
acdffffdffffffffdaaaaaaaaaaaaaaaaaaaaaaaaaaaaaaaaaaffffffffffffffaaaaa
acdffffdfffffffffaaaaaaaaaaaaaaaaaaaaaaaaaaaaaaaaaaffffffffffffffaaaaa
acdddddddddddddddaaaaaaaaaaaaaaaaaaaaaaaaaaaaaaaaaaffffffffffffffaaaaa
aggggggggggggggggggaaaaaaaaaaaaaaaaaaaaaaaaaaaaaaaaffffffffffffffaaaaa
aahhhhhhhhhhhhhhhaaaaaaaaaaaaaaaaaaaaaaaaaaaaaaaaaaffffffffffffffaaaaa
aahiiiiihjjjjjjjjaaaaaaaaaaaaaaaaaaaaaaaaaaaaaaaaaaffffffffffffffaaaaa
aahijjjjhjjjjjjjjaaaaaaaaaaaaaaaaaaaaaaaaaaaaaaaaaaffffffffffffffaaaaa
aahijjjjjjjjjjjjjaaaaaaaaaaaaaaaaaaaaaaaaaaaaaaaaaaaaaaaaaaaaaaaaaaaaa
aahhhhhhhhhhhhhhhaaaaaaaaaaaaaaaaaaaaaaaaaaaaaaaaaaaaaaaaaaaaaaaaaaaaa
aaaaaaaaaaaaaaaaaaaaaaaaaaaaaaaaaaaaaaaaaaaaaaaaaaaaaaaaaaaaaaaaaaaaaa
aaddddddddddddddaaaaaaaaaaaaaaaaaaaaaaaaaaaaaaaaaaaffffffffffffffaaaaa
aadffffdffffdffdaaaaaaaaaaaaaaaaaaaaaaaaaaaaaaaaaaaffffffffffffffaaaaa
aadffffdffffdffdaaaaaaaaaaaaaaaaaaaaaaaaaaaaaaaaaaaffffffffffffffaaaaa
aaddddkddddfddfdaaaaaaaaaaaaaaaaaaaaaaaaaaaaaaaaaaaffffffffffffffaaaaa
aadfffffffffffffaaaaaaaaaaaaaaaaaaaaaaaaaaaaaaaaaaaffffffffffffffaaaaa
aaddddfddddfdffdaaaaaaaaaaaaaaaaaaaaaaaaaaaaaaaaaaaffffffffffffffaaaaa
aadffffdlmnfddddaaaaaaaaaaaaaaaaaaaaaaaaaaaaaaaaaaaffffffffffffffaaaaa
aadffffdlmnffopdaaaaaaaaaaaaaaaaaaaaaaaaaaaaaaaaaaaffffffffffffffaaaaa
aadqfqfdffffdrodaaaaaaaaaaaaaaaaaaaaaaaaaaaaaaaaaaaffffffffffffffaaaaa
aaddddddddddddddaaaaaaaaaaaaaaaaaaaaaaaaaaaaaaaaaaaffffffffffffffaaaaa
aaaaaaaaaaaaaaaaaaaaaaaaaaaaaaaaaaaaaaaaaaaaaaaaaaaaaaaaaaaaaaaaaaaaaa
aaaaaaaaaaaaaaaaaaaaaaaaaaaaaaaaaaaaaaaaaaaaaaaaaaaaaaaaaaaaaaaaaaaaaa
aaaaaaaaaaaaaaaaaaaaaaaaaaaaaaaaaaaaaaaaaaaaaaaaaaaaaaaaaaaaaaaaaaaaaa
aaaaaaaaaaaaaaaaaaaaaaaaaaaaaaaaaaaaaaaaaaaaaaaaaaaaaaaaaaaaaaaaaaaaaa
aaaaaaaaaaaaaaaaaaaaaaaaaaaaaaaaaaaaaaaaaaaaaaaaaaaaaaaaaaaaaaaaaaaaaa
aaaaaaaaaaaaaaaaaaaaaaaaaaaaaaaaaaaaaaaaaaaaaaaaaaaaaaaaaaaaaaaaaaaaaa
aaaaaaaaaaaaaaaaaaaaaaaaaaaaaaaaaaaaaaaaaaaaaaaaaaaaaaaaaaaaaaaaaaaaaa
aaaaaaaaaaaaaaaaaaaaaaaaaaaaaaaaaaaaaaaaaaaaaaaaaaaaaaaaaaaaaaaaaaaaaa
aaaaaaaaaaaaaaaaaaaaaaaaaaaaaaaaaaaaaaaaaaaaaaaaaaaaaaaaaaaaaaaaaaaaaa
aaaaaaaaaaaaaaaaaaaaaaaaaaaaaaaaaaaaaaaaaaaaaaaaaaaaaaaaaaaaaaaaaaaaaa
aaaaaaaaaaaaaaaaaaaaaaaaaaaaaaaaaaaaaaaaaaaaaaaaaaaaaaaaaaaaaaaaaaaaaa
aaaaaaaaaaaaaaaaaaaaaaaaaaaaaaaaaaaaaaaaaaaaaaaaaaaaaaaaaaaaaaaaaaaaaa
aaaaaaaaaaaaaaaaaaaaaaaaaaaaaaaaaaaaaaaaaaaaaaaaaaaaaaaaaaaaaaaaaaaaaa
"}
