"aa" = (/turf/snow/gravsnow,/area/coldwar/outside)
"ab" = (/turf/simulated/floor/pavement,/area/coldwar/outside)
"ac" = (/turf/simulated/floor/road,/area/coldwar/outside)
"ad" = (/obj/structure/window/fence,/turf/snow/gravsnow,/area/coldwar/outside)
"ae" = (/obj/structure/window/fence{dir = 8},/turf/snow/gravsnow,/area/coldwar/outside)
"af" = (/turf/simulated/wall/wood,/area/coldwar/house1)
"ag" = (/obj/structure/window/fence{dir = 4},/turf/snow/gravsnow,/area/coldwar/outside)
"ah" = (/turf/simulated/floor/wood,/area/coldwar/house1)
"ai" = (/turf/simulated/wall/brck,/area/coldwar/outside)
"aj" = (/obj/structure/barricade,/turf/simulated/floor/wood,/area/coldwar/house1)
"ak" = (/turf/simulated/floor/wood,/area/coldwar/outside)
"al" = (/obj/structure/toilet,/turf/simulated/floor/tiled/white,/area/coldwar/house1)
"am" = (/turf/simulated/floor/tiled/white,/area/coldwar/house1)
"an" = (/obj/structure/bed,/obj/item/weapon/bedsheet,/turf/simulated/floor/wood,/area/coldwar/house1)
"ao" = (/obj/structure/bed/chair/wood{dir = 4},/turf/simulated/floor/wood,/area/coldwar/house1)
"ap" = (/obj/structure/table/standard,/turf/simulated/floor/wood,/area/coldwar/house1)
"aq" = (/obj/structure/bed/chair/wood{dir = 8},/turf/simulated/floor/wood,/area/coldwar/house1)
"ar" = (/obj/structure/bed/chair/wood{dir = 1},/turf/simulated/floor/wood,/area/coldwar/house1)
"as" = (/obj/structure/bed/chair/comfy,/turf/simulated/floor/wood,/area/coldwar/house1)
"at" = (/obj/structure/bed/chair/comfy{dir = 4},/turf/simulated/floor/wood,/area/coldwar/house1)
"au" = (/obj/structure/table/woodentable,/turf/simulated/floor/wood,/area/coldwar/house1)
"av" = (/obj/structure/bed/chair/comfy{dir = 1},/turf/simulated/floor/wood,/area/coldwar/house1)
"aw" = (/obj/structure/window/fence{dir = 1},/turf/snow/gravsnow,/area/coldwar/outside)
"ax" = (/obj/structure/bed,/obj/item/weapon/bedsheet/blue,/turf/simulated/floor/wood,/area/coldwar/house1)
"ay" = (/obj/structure/table/standard,/obj/item/weapon/grenade/frag,/turf/simulated/floor/wood,/area/coldwar/house1)
"az" = (/obj/machinery/door/unpowered/simple/wood/saloon,/turf/simulated/floor/wood,/area/coldwar/outside)
"aA" = (/turf/simulated/wall/wood,/area/coldwar/sa/sa_med)
"aB" = (/obj/structure/barricade,/turf/simulated/floor/wood,/area/coldwar/sa/sa_med)
"aC" = (/turf/snow/gravsnow,/area/coldwar/sa/sa_med)
"aD" = (/obj/structure/window/fence{dir = 4},/turf/snow/gravsnow,/area/coldwar/sa/sa_med)
"aE" = (/turf/simulated/floor/pavement,/area/coldwar/sa/sa_med)
"aF" = (/turf/simulated/floor/wood,/area/coldwar/sa/sa_med)
"aG" = (/obj/item/weapon/bedsheet,/obj/structure/bed,/turf/simulated/floor/wood,/area/coldwar/sa/sa_med)
"aH" = (/obj/structure/bed,/obj/item/weapon/bedsheet,/obj/structure/bed,/turf/simulated/floor/wood,/area/coldwar/sa/sa_med)
"aI" = (/obj/structure/bed,/obj/item/weapon/bedsheet,/turf/simulated/floor/wood,/area/coldwar/sa/sa_med)
"aJ" = (/obj/machinery/door/unpowered/simple/wood,/turf/simulated/floor/wood,/area/coldwar/sa/sa_med)
"aK" = (/obj/structure/window/fence{dir = 1},/turf/snow/gravsnow,/area/coldwar/sa/sa_med)
"aL" = (/turf/simulated/wall/concrete,/area/coldwar/sa/sa_med)
"aM" = (/obj/structure/table/steel,/turf/simulated/floor/fixed,/area/coldwar/sa/sa_med)
"aN" = (/turf/simulated/floor/fixed,/area/coldwar/sa/sa_med)
"aO" = (/obj/machinery/door/unpowered/simple/iron,/turf/simulated/floor/fixed,/area/coldwar/sa/sa_med)
"aP" = (/obj/structure/table/woodentable,/turf/simulated/floor/wood,/area/coldwar/sa/sa_med)
"aQ" = (/obj/structure/closet/cabinet,/turf/simulated/floor/wood,/area/coldwar/sa/sa_med)
"aR" = (/obj/machinery/optable,/turf/simulated/floor/wood,/area/coldwar/sa/sa_med)
"aS" = (/obj/structure/bed/chair/wood{dir = 4},/turf/simulated/floor/wood,/area/coldwar/sa/sa_med)
"aT" = (/obj/structure/table/steel,/turf/simulated/floor/wood,/area/coldwar/sa/sa_med)
"aU" = (/obj/structure/bed/chair/wood{dir = 8},/turf/simulated/floor/wood,/area/coldwar/sa/sa_med)
"aV" = (/turf/simulated/floor/tiled/white,/area/coldwar/sa/sa_med)
"aW" = (/obj/structure/sink/kitchen,/turf/simulated/floor/tiled/white,/area/coldwar/sa/sa_med)
"aX" = (/obj/structure/toilet{dir = 1},/turf/simulated/floor/tiled/white,/area/coldwar/sa/sa_med)
"aY" = (/obj/machinery/shower,/turf/simulated/floor/tiled/white,/area/coldwar/sa/sa_med)

(1,1,1) = {"
aaaaaaaaaaaaaaaaaaaaaaaaaaaaaaaaaaaaaaabaaaaaaabaaaaaaaaaaaaaaaaaaaaaaaaaaaaaaaaaaaaaaaaabacacacacabaaaaaaaaaaaaaaaaaaaaaaaaaaaaaaaaaaaaaaaa
aaaaaaaaaaaaaaaaaaaaaaaaaaaaaaaaaaaaaaabacacacabaaaaaaaaaaaaaaaaaaaaaaaaaaaaaaaaaaaaaaaaabacacacacabaaaaaaaaaaaaaaaaaaaaaaaaaaaaaaaaaaaaaaaa
aaaaaaaaaaaaaaaaaaaaaaaaaaaaaaaaaaaaaaabacacacabaaaaaaaaaaaaaaaaaaaaaaaaaaaaaaaaaaaaaaaaabacacacacabaaaaaaaaaaaaaaaaaaaaaaaaaaaaaaaaaaaaaaaa
aaaaaaaaaaaaaaaaaaaaaaaaaaaaaaaaaaaaaaabacacacabaaaaaaaaaaaaaaaaaaaaaaaaaaaaaaaaaaaaaaaaabacacacacabaaaaaaaaaaaaaaaaaaaaaaaaaaaaaaaaaaaaaaaa
aaadadadadadadadadadadadadadadadadadadabacacacabaaaaaaaaaaaaaaaaaaaaaaaaaaaaaaaaaaaaaaaaabacacacacabaaaaaaaaaaaaaaaaaaaaaaaaaaaaaaaaaaaaaaaa
aaaeafafafafafaaaaaaaaaaaaaaaaaaaaaaagabacacacabaaaaaaaaaaaaaaaaaaaaaaaaaaaaaaaaaaaaaaaaabacacacacabaaaaaaaaaaaaaaaaaaaaaaaaaaaaaaaaaaaaaaaa
aaaeafahahahafaaaaaaaaaaaaaaaaaaaaaaagabacacacabaaaaaaaaaaaaaaaaaaaaaaaaaaaaaaaaaaaaaaaaabacacacacabaaaaaaaaaaaaaaaaaaaaaaaaaaaaaaaaaaaaaaaa
aaaeafahahahafaaaaaaaaaaaaaaaaaaaaaaagabacacacabaaaiaiaiaiaiaiaiaiaiaiaiaiaiaiaiaiaiaiaaabacacacacabaaaaaaaaaaaaaaaaaaaaaaaaaaaaaaaaaaaaaaaa
aaaeafafajafafaaaaaaaaaaaaaaaaaaaaaaagabacacacabaaaiakakakakakakakakakakakakakakakakaiaaabacacacacabaaafafafafafafafafafafafafafafaaaaaaaaaa
aaaeaaaaaaaaaaaaaaaaaaaaaaaaaaaaaaaaagabacacacabaaaiakakakakakakakakakakakakakakakakaiaaabacacacacabaaafahahafahahahahahafalamamafaaaaaaaaaa
aaaeaaaaaaaaaaaaaaaaaaaaaaaaaaaaaaaaagabacacacabaaaiakakakakakakakakakakakakakakakakaiaaabacacacacabaaafahahahahahahahahafamamamafaaaaaaaaaa
aaaeafafafafafafafafafafafafafafafaaagabacacacabaaaiakakakakakakakakakakakakakakakakaiaaabacacacacabaaafafahafafafafafafafafafahafaaaaaaaaaa
aaaeafahanahanafaoapapaqahafahahafaaagabacacacabaaaiakakakakakakakakakakakakakakakakaiaaabacacacacabaaafahahahahafahahahafahahahafaaaaaaaaaa
aaaeafahanahanafahararahahahahahafaaagabacacacabaaaiakakakakakakakakakakakakakakakakaiaaabacacacacabaaafahahahahafahahahafahahahafaaaaaaaaaa
aaaeafahahahahahahahahahahafahahafaaaaabacacacabaaaiakakakakakakakakakakakakakakakakaiaaabacacacacabaaafahasahahahahahahahahahahafaaaaaaaaaa
aaaeafahanahanafahahahahahafahahahabababacacacabaaaiakakakakakakakakakakakakakakakakaiaaabacacacacabaaafatauahahafaoauaqafahahahafaaaaaaaaaa
aaaeafafafafafafafafafafafafafafafabagabacacacabaaaiakakakakakakakakakakakakakakakakaiaaabacacacacabaaafahavahahafaoauaqafahahahafaaaaaaaaaa
aaaeaaaaaaaaaaaaaaaaaaaaaaaaaaaaaaaaagabacacacabaaaiakakakakakakakakakakakakakakakakaiaaabacacacacabaaafafafafafafafafafafafafafafaaaaaaaaaa
aaaeaaaaaaaaaaaaaaaaaaaaaaaaaaaaaaaaagabacacacabaaaiaiaiaiaiaiaiaiakakakaiaiaiaiaiaiaiaaabacacacacabaaaaaaaaaaaaaaaaaaaaaaaaaaaaaaaaaaaaaaaa
aaaeaaaaaaaaaaaaaaaaaaaaaaaaaaaaaaaaagabacacacabaaaaaaaaaaaaaaaaaiakakakaiaaaaaaaaaaaaaaabacacacacabaaaaaaaaaaaaaaaaaaaaaaaaaaaaaaaaaaaaaaaa
aaaeaaaaaaaaaaaaaaaaaaaaaaaaaaaaaaaaagabacacacabaaaaaaaaaaaaaaaaaiakakakaiaaaaaaaaaaaaaaabacacacacabaaaaaaaaaaaaaaaaaaaaaaaaaaaaaaaaaaaaaaaa
aaawawawawawawawawawawawawawawawawawawabacacacabaaaaaaaaaaaaaaaaaiakakakaiaaaaaaaaaaaaaaabacacacacabaaafafafafafafafafafafafafafafaaaaaaaaaa
aaaeaaaaaaaaaaaaaaaaaaaaaaaaaaaaaaaaagabacacacabaaaaaaaaaaaaaaaaaiakakakaiaaaaaaaaaaaaaaabacacacacabaaafahahafahahahahahafalamamafaaaaaaaaaa
aaaeaaaaaaaaaaaaaaaaaaaaaaaaaaaaaaaaagabacacacabaaaaaaaaaaaaaaaaaiakakakaiaaaaaaaaaaaaaaabacacacacabaaafahahahahahahahahafamamamafaaaaaaaaaa
aaaeafafajafafafafafafafafafafafafaaagabacacacabaaaaaaaaaaaaaaaaaiakakakaiaaaaaaaaaaaaaaabacacacacabaaafafahafafafafafafafafafahafaaaaaaaaaa
aaaeafahahahafaxaxaxafaoayaqahahafaaagabacacacabaaaaaaaaaaaaaaaaaiakakakaiaaaaaaaaaaaaaaabacacacacabaaafahahahahafahahahafahahahafaaaaaaaaaa
aaaeafahahahafahahahahaharahahahafaaagabacacacabaaaaaaaaaaaaaaaaaiakakakaiaaaaaaaaaaaaaaabacacacacabaaafahahahahafahahahafahahahafaaaaaaaaaa
aaaeafahahahafaxaxaxafahahahahahahabababacacacabaaaaaaaaaaaaaaaaaiakakakaiaaaaaaaaaaaaaaabacacacacabaaafahasahahahahahahahahahahafaaaaaaaaaa
aaaeafafafafafafafafafafafafafafafaaagabacacacabaaaaaaaaaaaaaaaaaiazazazaiaaaaaaaaaaaaaaabacacacacabaaafatauahahafaoauaqafahahahafaaaaaaaaaa
aaaeaaaaaaaaaaaaaaaaaaaaaaaaaaaaaaaaagabacacacabaaaaaaaaaaaaaaaaaaaaaaaaaaaaaaaaaaaaaaaaabacacacacabaaafahavahahafaoauaqafahahahafaaaaaaaaaa
aaadawawawawawawawawawawawawawawawawawabacacacabaaaaaaaaaaaaaaaaaaaaaaaaaaaaaaaaaaaaaaaaabacacacacabaaafafafafafafafafafafafafafafaaaaaaaaaa
aaaeaaaaaaaaaaaaaaaaaaaaaaaaaaaaaaaaagabacacacabaaaaaaaaaaaaaaaaaaaaaaaaaaaaaaaaaaaaaaaaabacacacacabaaaaaaaaaaaaaaaaaaaaaaaaaaaaaaaaaaaaaaaa
aaaeaaaaaaaaaaaaaaaaaaaaaaaaaaaaaaaaagabacacacababababababababababababababababababababababacacacacabaaaaaaaaaaaaaaaaaaaaaaaaaaaaaaaaaaaaaaaa
aaaeaaaaaaaaaaaaaaaaaaaaaaaaaaaaaaaaagabacacacababababababababababababababababababababababacacacacabaaaaaaaaaaaaaaaaaaaaaaaaaaaaaaaaaaaaaaaa
aaaeaaaaaaaaaaaaaaaaaaaaaaaaaaaaaaaaagabacacacababababababababababababababababababababababacacacacabaaafafafafafafafafafafafafafafaaaaaaaaaa
aaaeaAaAaBaAaAaAaAaAaAaAaAaAaAaAaAaCaDaEacacacababababababababababababababababababababababacacacacabaaafahahafahahahahahafalamamafaaaaaaaaaa
aaaeaAaFaFaFaFaAaGaHaIaAaGaGaGaGaAaCaDaEacacacababababababababababababababababababababababacacacacababafahahahahahahahahafamamamafaaaaaaaaaa
aaaeaAaFaFaFaFaAaFaFaFaFaFaFaFaFaAaEaEaEacacacababababababababababababababababababababababacacacacabaaafafahafafafafafafafafafahafaaaaaaaaaa
aaaeaAaFaFaFaFaAaGaIaIaGaGaGaGaFaJaEaEaEacacacababababababababababababababababababababababacacacacabaaafahahahahafahahahafahahahafaaaaaaaaaa
aaaeaAaAaAaAaAaAaAaAaAaAaAaAaAaAaAaEaEaEacacacababababababababababababababababababababababacacacacabaaafahahahahafahahahafahahahafaaaaaaaaaa
aaawaKaKaKaKaKaKaKaKaKaKaKaKaKaKaKaKaKaEacacacababababababababababababababababababababababacacacacabaaafahasahahahahahahahahahahafaaaaaaaaaa
aaaaaLaLaLaLaLaLaLaLaLaLaLaLaLaLaLaCaCaEacacacababababababababababababababababababababababacacacacabaaafatauahahafaoauaqafahahahafaaaaaaaaaa
aaaaaLaMaMaMaMaMaLaNaNaNaNaNaNaNaOaCaCaEacacacababababababababababababababababababababababacacacacabaaafahavahahafaoauaqafahahahafaaaaaaaaaa
aaaaaLaMaNaNaNaNaLaNaNaNaNaNaNaNaOaCaCaEacacacababababababababababababababababababababababacacacacabaaafafafafafafafafafafafafafafaaaaaaaaaa
aaaaaLaMaNaNaNaNaNaNaNaNaNaNaNaNaOaCaCaEacacacababababababababababababababababababababababacacacacabaaaaaaaaaaaaaaaaaaaaaaaaaaaaaaaaaaaaaaaa
aaaaaLaLaLaLaLaLaLaLaLaLaLaLaLaLaLaCaCaEacacacababababababababababababababababababababababacacacacabaaaaaaaaaaaaaaaaaaaaaaaaaaaaaaaaaaaaaaaa
aaaaaCaCaCaCaCaCaCaCaCaCaCaCaCaCaCaCaCaEacacacababababababababababababababababababababababacacacacabaaaaaaaaaaaaaaaaaaaaaaaaaaaaaaaaaaaaaaaa
aaaaaAaAaAaAaAaAaAaAaAaAaAaAaAaAaCaCaCaEacacacababababababababababababababababababababababacacacacabaaafafafafafafafafafafafafafafaaaaaaaaaa
aaaaaAaPaFaPaPaAaPaFaPaPaAaQaQaAaCaCaCaEacacacababababababababababababababababababababababacacacacabaaafahahafahahahahahafalamamafaaaaaaaaaa
aaaaaAaRaFaFaFaAaRaFaFaFaAaFaFaAaCaCaCaEacacacababababababababababababababababababababababacacacacababafahahahahahahahahafamamamafaaaaaaaaaa
aaaaaAaAaAaAaJaAaAaAaAaJaAaAaJaAaEaEaEaEacacacababababababababababababababababababababababacacacacabaaafafahafafafafafafafafafahafaaaaaaaaaa
aaaaaAaFaFaFaFaFaFaFaFaFaFaFaFaJaEaEaEaEacacacababababababababababababababababababababababacacacacabaaafahahahahafahahahafahahahafaaaaaaaaaa
aaaaaAaAaAaAaJaAaAaAaAaJaAaFaFaAaEaEaEaEacacacababababababababababababababababababababababacacacacabaaafahahahahafahahahafahahahafaaaaaaaaaa
aaaaaAaIaFaFaFaAaSaTaUaFaAaAaAaAaaaaaaabacacacababababababababababababababababababababababacacacacabaaafahasahahahahahahahahahahafaaaaaaaaaa
aaaaaAaIaFaFaGaAaSaTaUaFaJaVaWaAaaaaaaabacacacababababababababababababababababababababababacacacacabaaafatauahahafaoauaqafahahahafaaaaaaaaaa
aaaaaAaIaFaFaGaAaFaFaFaFaAaVaVaAaaaaaaabacacacababababababababababababababababababababababacacacacabaaafahavahahafaoauaqafahahahafaaaaaaaaaa
aaaaaAaFaIaIaFaAaPaPaQaQaAaXaYaAaaaaaaabacacacababababababababababababababababababababababacacacacabaaafafafafafafafafafafafafafafaaaaaaaaaa
aaaaaAaAaAaAaAaAaAaAaAaAaAaAaAaAaaaaaaabacacacababababababababababababababababababababababacacacacabaaaaaaaaaaaaaaaaaaaaaaaaaaaaaaaaaaaaaaaa
aaaaaaaaaaaaaaaaaaaaaaaaaaaaaaaaaaaaaaabacacacababababababababababababababababababababababacacacacabaaaaaaaaaaaaaaaaaaaaaaaaaaaaaaaaaaaaaaaa
aaaaaaaaaaaaaaaaaaaaaaaaaaaaaaaaaaaaaaabacacacababababababababababababababababababababababacacacacabaaaaaaaaaaaaaaaaaaaaaaaaaaaaaaaaaaaaaaaa
aaaaaaaaaaaaaaaaaaaaaaaaaaaaaaaaaaaaaaabacacacababababababababababababababababababababababacacacacabaaaaaaaaaaaaaaaaaaaaaaaaaaaaaaaaaaaaaaaa
aaaaaaaaaaaaaaaaaaaaaaaaaaaaaaaaaaaaaaabacacacababababababababababababababababababababababacacacacabaaaaaaaaaaaaaaaaaaaaaaaaaaaaaaaaaaaaaaaa
aaaaaaaaaaaaaaaaaaaaaaaaaaaaaaaaaaaaaaabacacacababababababababababababababababababababababacacacacabaaaaaaaaaaaaaaaaaaaaaaaaaaaaaaaaaaaaaaaa
aaaaaaaaaaaaaaaaaaaaaaaaaaaaaaaaaaaaaaabacacacababababababababababababababababababababababacacacacabaaaaaaaaaaaaaaaaaaaaaaaaaaaaaaaaaaaaaaaa
ababababababababababababababababababababacacacababababababababababababababababababababababacacacacababababababababababababababababababababab
acacacacacacacacacacacacacacacacacacacacacacacacacacacacacacacacacacacacacacacacacacacacacacacacacacacacacacacacacacacacacacacacacacacacacac
acacacacacacacacacacacacacacacacacacacacacacacacacacacacacacacacacacacacacacacacacacacacacacacacacacacacacacacacacacacacacacacacacacacacacac
acacacacacacacacacacacacacacacacacacacacacacacacacacacacacacacacacacacacacacacacacacacacacacacacacacacacacacacacacacacacacacacacacacacacacac
acacacacacacacacacacacacacacacacacacacacacacacacacacacacacacacacacacacacacacacacacacacacacacacacacacacacacacacacacacacacacacacacacacacacacac
abababababababababababababababababababababababababababababababababababababababababababababababababababababababababababababababababababababab
"}
