"aa" = (/turf/snow/gravsnow,/area/coldwar/outside)
"ab" = (/turf/simulated/floor/pavement,/area/coldwar/outside)
"ac" = (/turf/simulated/floor/road,/area/coldwar/outside)
"ad" = (/obj/structure/window/fence,/turf/snow/gravsnow,/area/coldwar/outside)
"ae" = (/obj/structure/window/fence{dir = 8},/turf/snow/gravsnow,/area/coldwar/outside)
"af" = (/turf/simulated/wall/wood,/area/coldwar/house1)
"ag" = (/obj/structure/window/fence{dir = 4},/turf/snow/gravsnow,/area/coldwar/outside)
"ah" = (/turf/simulated/floor/wood,/area/coldwar/house1)
"ai" = (/turf/simulated/wall/brck,/area/coldwar/outside)
"aj" = (/obj/structure/barricade,/turf/simulated/floor/wood,/area/coldwar/house1)
"ak" = (/turf/simulated/floor/wood,/area/coldwar/outside)
"al" = (/turf/simulated/floor/wood,/area/coldwar/sa/spawn_area/sa_soldiers)
"am" = (/obj/structure/toilet,/turf/simulated/floor/tiled/white,/area/coldwar/sa/spawn_area/sa_soldiers)
"an" = (/turf/simulated/floor/tiled/white,/area/coldwar/sa/spawn_area/sa_soldiers)
"ao" = (/turf/simulated/floor/wood,/area/coldwar/sa/spawn_area/cz_soldiers)
"ap" = (/obj/structure/bed,/obj/item/weapon/bedsheet,/turf/simulated/floor/wood,/area/coldwar/sa/spawn_area/cz_soldiers)
"aq" = (/obj/structure/bed/chair/wood{dir = 4},/turf/simulated/floor/wood,/area/coldwar/sa/spawn_area/cz_soldiers)
"ar" = (/obj/structure/table/standard,/turf/simulated/floor/wood,/area/coldwar/house1)
"as" = (/obj/structure/bed/chair/wood{dir = 8},/turf/simulated/floor/wood,/area/coldwar/sa/spawn_area/cz_soldiers)
"at" = (/obj/structure/bed/chair/wood{dir = 1},/turf/simulated/floor/wood,/area/coldwar/sa/spawn_area/cz_soldiers)
"au" = (/turf/simulated/floor/wood,/area/coldwar/sa/spawn_area/sa_officers)
"av" = (/turf/simulated/floor/wood,/area/coldwar/sa/spawn_area/cz_officers)
"aw" = (/obj/structure/bed/chair/comfy,/turf/simulated/floor/wood,/area/coldwar/sa/spawn_area/sa_soldiers)
"ax" = (/obj/structure/bed/chair/comfy{dir = 4},/turf/simulated/floor/wood,/area/coldwar/sa/spawn_area/sa_soldiers)
"ay" = (/obj/structure/table/woodentable,/turf/simulated/floor/wood,/area/coldwar/house1)
"az" = (/obj/structure/bed/chair/wood{dir = 4},/turf/simulated/floor/wood,/area/coldwar/sa/spawn_area/sa_soldiers)
"aA" = (/obj/structure/bed/chair/wood{dir = 8},/turf/simulated/floor/wood,/area/coldwar/sa/spawn_area/sa_soldiers)
"aB" = (/obj/structure/bed/chair/comfy{dir = 1},/turf/simulated/floor/wood,/area/coldwar/sa/spawn_area/sa_soldiers)
"aC" = (/obj/structure/window/fence{dir = 1},/turf/snow/gravsnow,/area/coldwar/outside)
"aD" = (/obj/structure/bed,/obj/item/weapon/bedsheet/blue,/turf/simulated/floor/wood,/area/coldwar/sa/spawn_area/sa_soldiers)
"aE" = (/obj/structure/table/standard,/obj/item/weapon/grenade/frag,/turf/simulated/floor/wood,/area/coldwar/house1)
"aF" = (/obj/structure/bed/chair/wood{dir = 1},/turf/simulated/floor/wood,/area/coldwar/sa/spawn_area/sa_soldiers)
"aG" = (/obj/machinery/door/unpowered/simple/wood/saloon,/turf/simulated/floor/wood,/area/coldwar/outside)
"aH" = (/turf/simulated/wall/wood,/area/coldwar/sa/sa_med)
"aI" = (/obj/structure/barricade,/turf/simulated/floor/wood,/area/coldwar/sa/sa_med)
"aJ" = (/turf/snow/gravsnow,/area/coldwar/sa/sa_med)
"aK" = (/obj/structure/window/fence{dir = 4},/turf/snow/gravsnow,/area/coldwar/sa/sa_med)
"aL" = (/turf/simulated/floor/pavement,/area/coldwar/sa/sa_med)
"aM" = (/turf/simulated/floor/wood,/area/coldwar/sa/sa_med)
"aN" = (/obj/item/weapon/bedsheet,/obj/structure/bed,/turf/simulated/floor/wood,/area/coldwar/sa/sa_med)
"aO" = (/obj/structure/bed,/obj/item/weapon/bedsheet,/obj/structure/bed,/turf/simulated/floor/wood,/area/coldwar/sa/sa_med)
"aP" = (/obj/structure/bed,/obj/item/weapon/bedsheet,/turf/simulated/floor/wood,/area/coldwar/sa/sa_med)
"aQ" = (/obj/machinery/door/unpowered/simple/wood,/turf/simulated/floor/wood,/area/coldwar/sa/sa_med)
"aR" = (/obj/structure/window/fence{dir = 1},/turf/snow/gravsnow,/area/coldwar/sa/sa_med)
"aS" = (/obj/structure/bed/chair/comfy,/turf/simulated/floor/wood,/area/coldwar/sa/spawn_area/cz_soldiers)
"aT" = (/turf/simulated/wall/concrete,/area/coldwar/sa/sa_med)
"aU" = (/obj/structure/bed/chair/comfy{dir = 4},/turf/simulated/floor/wood,/area/coldwar/sa/spawn_area/cz_soldiers)
"aV" = (/obj/structure/table/steel,/turf/simulated/floor/fixed,/area/coldwar/sa/sa_med)
"aW" = (/turf/simulated/floor/fixed,/area/coldwar/sa/sa_med)
"aX" = (/obj/machinery/door/unpowered/simple/iron,/turf/simulated/floor/fixed,/area/coldwar/sa/sa_med)
"aY" = (/obj/structure/bed/chair/comfy{dir = 1},/turf/simulated/floor/wood,/area/coldwar/house1)
"aZ" = (/obj/structure/table/woodentable,/turf/simulated/floor/wood,/area/coldwar/sa/sa_med)
"ba" = (/obj/structure/closet/cabinet,/turf/simulated/floor/wood,/area/coldwar/sa/sa_med)
"bb" = (/obj/structure/toilet,/turf/simulated/floor/tiled/white,/area/coldwar/sa/spawn_area/cz_soldiers)
"bc" = (/turf/simulated/floor/tiled/white,/area/coldwar/sa/spawn_area/cz_soldiers)
"bd" = (/obj/machinery/optable,/turf/simulated/floor/wood,/area/coldwar/sa/sa_med)
"be" = (/obj/structure/bed/chair/wood{dir = 4},/turf/simulated/floor/wood,/area/coldwar/sa/sa_med)
"bf" = (/obj/structure/table/steel,/turf/simulated/floor/wood,/area/coldwar/sa/sa_med)
"bg" = (/obj/structure/bed/chair/wood{dir = 8},/turf/simulated/floor/wood,/area/coldwar/sa/sa_med)
"bh" = (/turf/simulated/floor/tiled/white,/area/coldwar/sa/sa_med)
"bi" = (/obj/structure/sink/kitchen,/turf/simulated/floor/tiled/white,/area/coldwar/sa/sa_med)
"bj" = (/obj/structure/bed/chair/comfy{dir = 1},/turf/simulated/floor/wood,/area/coldwar/sa/spawn_area/cz_soldiers)
"bk" = (/obj/structure/toilet{dir = 1},/turf/simulated/floor/tiled/white,/area/coldwar/sa/sa_med)
"bl" = (/obj/machinery/shower,/turf/simulated/floor/tiled/white,/area/coldwar/sa/sa_med)

(1,1,1) = {"
aaaaaaaaaaaaaaaaaaaaaaaaaaaaaaaaaaaaaaabaaaaaaabaaaaaaaaaaaaaaaaaaaaaaaaaaaaaaaaaaaaaaaaabacacacacabaaaaaaaaaaaaaaaaaaaaaaaaaaaaaaaaaaaaaaaa
aaaaaaaaaaaaaaaaaaaaaaaaaaaaaaaaaaaaaaabacacacabaaaaaaaaaaaaaaaaaaaaaaaaaaaaaaaaaaaaaaaaabacacacacabaaaaaaaaaaaaaaaaaaaaaaaaaaaaaaaaaaaaaaaa
aaaaaaaaaaaaaaaaaaaaaaaaaaaaaaaaaaaaaaabacacacabaaaaaaaaaaaaaaaaaaaaaaaaaaaaaaaaaaaaaaaaabacacacacabaaaaaaaaaaaaaaaaaaaaaaaaaaaaaaaaaaaaaaaa
aaaaaaaaaaaaaaaaaaaaaaaaaaaaaaaaaaaaaaabacacacabaaaaaaaaaaaaaaaaaaaaaaaaaaaaaaaaaaaaaaaaabacacacacabaaaaaaaaaaaaaaaaaaaaaaaaaaaaaaaaaaaaaaaa
aaadadadadadadadadadadadadadadadadadadabacacacabaaaaaaaaaaaaaaaaaaaaaaaaaaaaaaaaaaaaaaaaabacacacacabaaaaaaaaaaaaaaaaaaaaaaaaaaaaaaaaaaaaaaaa
aaaeafafafafafaaaaaaaaaaaaaaaaaaaaaaagabacacacabaaaaaaaaaaaaaaaaaaaaaaaaaaaaaaaaaaaaaaaaabacacacacabaaaaaaaaaaaaaaaaaaaaaaaaaaaaaaaaaaaaaaaa
aaaeafahahahafaaaaaaaaaaaaaaaaaaaaaaagabacacacabaaaaaaaaaaaaaaaaaaaaaaaaaaaaaaaaaaaaaaaaabacacacacabaaaaaaaaaaaaaaaaaaaaaaaaaaaaaaaaaaaaaaaa
aaaeafahahahafaaaaaaaaaaaaaaaaaaaaaaagabacacacabaaaiaiaiaiaiaiaiaiaiaiaiaiaiaiaiaiaiaiaaabacacacacabaaaaaaaaaaaaaaaaaaaaaaaaaaaaaaaaaaaaaaaa
aaaeafafajafafaaaaaaaaaaaaaaaaaaaaaaagabacacacabaaaiakakakakakakakakakakakakakakakakaiaaabacacacacabaaafafafafafafafafafafafafafafaaaaaaaaaa
aaaeaaaaaaaaaaaaaaaaaaaaaaaaaaaaaaaaagabacacacabaaaiakakakakakakakakakakakakakakakakaiaaabacacacacabaaafalalafalalalalalafamananafaaaaaaaaaa
aaaeaaaaaaaaaaaaaaaaaaaaaaaaaaaaaaaaagabacacacabaaaiakakakakakakakakakakakakakakakakaiaaabacacacacabaaafalalalalalalalalafanananafaaaaaaaaaa
aaaeafafafafafafafafafafafafafafafaaagabacacacabaaaiakakakakakakakakakakakakakakakakaiaaabacacacacabaaafafalafafafafafafafafafahafaaaaaaaaaa
aaaeafaoapaoapafaqararasaoafaoaoafaaagabacacacabaaaiakakakakakakakakakakakakakakakakaiaaabacacacacabaaafalalalalafalalalafalalalafaaaaaaaaaa
aaaeafaoapaoapafaoatataoaoaoaoaoafaaagabacacacabaaaiakakakakakakakauakakakakakakakakaiaaabacacacacabaaafalalalalafalalalafalalalafaaaaaaaaaa
aaaeafaoaoaoaoaoaoaoaoaoaoafaoaoafaaaaabacacacabaaaiauauauauauauauauauavavavavavavavaiaaabacacacacabaaafalawalalalalalalalalalalafaaaaaaaaaa
aaaeafaoapaoapafaoaoaoaoaoafaoaoahabababacacacabaaaiauauauauauauauauauavavavavavavavaiaaabacacacacabaaafaxayalalafazayaAafalalalafaaaaaaaaaa
aaaeafafafafafafafafafafafafafafafabagabacacacabaaaiauauauauauauauauauavavavavavavavaiaaabacacacacabaaafalaBalalafazayaAafalalalafaaaaaaaaaa
aaaeaaaaaaaaaaaaaaaaaaaaaaaaaaaaaaaaagabacacacabaaaiauauauauauauauauauavavavavavavavaiaaabacacacacabaaafafafafafafafafafafafafafafaaaaaaaaaa
aaaeaaaaaaaaaaaaaaaaaaaaaaaaaaaaaaaaagabacacacabaaaiaiaiaiaiaiaiaiauauavaiaiaiaiaiaiaiaaabacacacacabaaaaaaaaaaaaaaaaaaaaaaaaaaaaaaaaaaaaaaaa
aaaeaaaaaaaaaaaaaaaaaaaaaaaaaaaaaaaaagabacacacabaaaaaaaaaaaaaaaaaiauauavaiaaaaaaaaaaaaaaabacacacacabaaaaaaaaaaaaaaaaaaaaaaaaaaaaaaaaaaaaaaaa
aaaeaaaaaaaaaaaaaaaaaaaaaaaaaaaaaaaaagabacacacabaaaaaaaaaaaaaaaaaiauauavaiaaaaaaaaaaaaaaabacacacacabaaaaaaaaaaaaaaaaaaaaaaaaaaaaaaaaaaaaaaaa
aaaCaCaCaCaCaCaCaCaCaCaCaCaCaCaCaCaCaCabacacacabaaaaaaaaaaaaaaaaaiauauavaiaaaaaaaaaaaaaaabacacacacabaaafafafafafafafafafafafafafafaaaaaaaaaa
aaaeaaaaaaaaaaaaaaaaaaaaaaaaaaaaaaaaagabacacacabaaaaaaaaaaaaaaaaaiauauavaiaaaaaaaaaaaaaaabacacacacabaaafalalafalalalalalafamananafaaaaaaaaaa
aaaeaaaaaaaaaaaaaaaaaaaaaaaaaaaaaaaaagabacacacabaaaaaaaaaaaaaaaaaiauauavaiaaaaaaaaaaaaaaabacacacacabaaafalalalalalalalalafanananafaaaaaaaaaa
aaaeafafajafafafafafafafafafafafafaaagabacacacabaaaaaaaaaaaaaaaaaiauauavaiaaaaaaaaaaaaaaabacacacacabaaafafahafafafafafafafafafahafaaaaaaaaaa
aaaeafahahahafaDaDaDafazaEaAalalafaaagabacacacabaaaaaaaaaaaaaaaaaiauauavaiaaaaaaaaaaaaaaabacacacacabaaafalalalalafalalalafalalalafaaaaaaaaaa
aaaeafahahahafalalalahalaFalalalafaaagabacacacabaaaaaaaaaaaaaaaaaiauauavaiaaaaaaaaaaaaaaabacacacacabaaafalalalalafalalalafalalalafaaaaaaaaaa
aaaeafahahahafaDaDaDafalalalalalahabababacacacabaaaaaaaaaaaaaaaaaiauauavaiaaaaaaaaaaaaaaabacacacacabaaafalawalalahalalalahalalalafaaaaaaaaaa
aaaeafafafafafafafafafafafafafafafaaagabacacacabaaaaaaaaaaaaaaaaaiaGaGaGaiaaaaaaaaaaaaaaabacacacacabaaafaxayalalafazayaAafalalalafaaaaaaaaaa
aaaeaaaaaaaaaaaaaaaaaaaaaaaaaaaaaaaaagabacacacabaaaaaaaaaaaaaaaaaaaaaaaaaaaaaaaaaaaaaaaaabacacacacabaaafalaBalalafazayaAafalalalafaaaaaaaaaa
aaadaCaCaCaCaCaCaCaCaCaCaCaCaCaCaCaCaCabacacacabaaaaaaaaaaaaaaaaaaaaaaaaaaaaaaaaaaaaaaaaabacacacacabaaafafafafafafafafafafafafafafaaaaaaaaaa
aaaeaaaaaaaaaaaaaaaaaaaaaaaaaaaaaaaaagabacacacabaaaaaaaaaaaaaaaaaaaaaaaaaaaaaaaaaaaaaaaaabacacacacabaaaaaaaaaaaaaaaaaaaaaaaaaaaaaaaaaaaaaaaa
aaaeaaaaaaaaaaaaaaaaaaaaaaaaaaaaaaaaagabacacacababababababababababababababababababababababacacacacabaaaaaaaaaaaaaaaaaaaaaaaaaaaaaaaaaaaaaaaa
aaaeaaaaaaaaaaaaaaaaaaaaaaaaaaaaaaaaagabacacacababababababababababababababababababababababacacacacabaaaaaaaaaaaaaaaaaaaaaaaaaaaaaaaaaaaaaaaa
aaaeaaaaaaaaaaaaaaaaaaaaaaaaaaaaaaaaagabacacacababababababababababababababababababababababacacacacabaaafafafafafafafafafafafafafafaaaaaaaaaa
aaaeaHaHaIaHaHaHaHaHaHaHaHaHaHaHaHaJaKaLacacacababababababababababababababababababababababacacacacabaaafalalafalalalalalafamananafaaaaaaaaaa
aaaeaHaMaMaMaMaHaNaOaPaHaNaNaNaNaHaJaKaLacacacababababababababababababababababababababababacacacacababafalalalalalalalalafanananafaaaaaaaaaa
aaaeaHaMaMaMaMaHaMaMaMaMaMaMaMaMaHaLaLaLacacacababababababababababababababababababababababacacacacabaaafafahafafafafafafafafafahafaaaaaaaaaa
aaaeaHaMaMaMaMaHaNaPaPaNaNaNaNaMaQaLaLaLacacacababababababababababababababababababababababacacacacabaaafaoaoaoaoafaoaoaoafaoaoaoafaaaaaaaaaa
aaaeaHaHaHaHaHaHaHaHaHaHaHaHaHaHaHaLaLaLacacacababababababababababababababababababababababacacacacabaaafaoaoaoaoafaoaoaoafaoaoaoafaaaaaaaaaa
aaaCaRaRaRaRaRaRaRaRaRaRaRaRaRaRaRaRaRaLacacacababababababababababababababababababababababacacacacabaaafaoaSaoaoaoaoaoaoahaoaoaoafaaaaaaaaaa
aaaaaTaTaTaTaTaTaTaTaTaTaTaTaTaTaTaJaJaLacacacababababababababababababababababababababababacacacacabaaafaUayaoaoafaqayasafaoaoaoafaaaaaaaaaa
aaaaaTaVaVaVaVaVaTaWaWaWaWaWaWaWaXaJaJaLacacacababababababababababababababababababababababacacacacabaaafaoaYaoaoafaqayasafaoaoaoafaaaaaaaaaa
aaaaaTaVaWaWaWaWaTaWaWaWaWaWaWaWaXaJaJaLacacacababababababababababababababababababababababacacacacabaaafafafafafafafafafafafafafafaaaaaaaaaa
aaaaaTaVaWaWaWaWaWaWaWaWaWaWaWaWaXaJaJaLacacacababababababababababababababababababababababacacacacabaaaaaaaaaaaaaaaaaaaaaaaaaaaaaaaaaaaaaaaa
aaaaaTaTaTaTaTaTaTaTaTaTaTaTaTaTaTaJaJaLacacacababababababababababababababababababababababacacacacabaaaaaaaaaaaaaaaaaaaaaaaaaaaaaaaaaaaaaaaa
aaaaaJaJaJaJaJaJaJaJaJaJaJaJaJaJaJaJaJaLacacacababababababababababababababababababababababacacacacabaaaaaaaaaaaaaaaaaaaaaaaaaaaaaaaaaaaaaaaa
aaaaaHaHaHaHaHaHaHaHaHaHaHaHaHaHaJaJaJaLacacacababababababababababababababababababababababacacacacabaaafafafafafafafafafafafafafafaaaaaaaaaa
aaaaaHaZaMaZaZaHaZaMaZaZaHbabaaHaJaJaJaLacacacababababababababababababababababababababababacacacacabaaafaoaoafaoaoaoaoaoafbbbcbcafaaaaaaaaaa
aaaaaHbdaMaMaMaHbdaMaMaMaHaMaMaHaJaJaJaLacacacababababababababababababababababababababababacacacacababafaoaoaoaoaoaoaoaoafbcbcbcafaaaaaaaaaa
aaaaaHaHaHaHaQaHaHaHaHaQaHaHaQaHaLaLaLaLacacacababababababababababababababababababababababacacacacabaaafafahafafafafafafafafafahafaaaaaaaaaa
aaaaaHaMaMaMaMaMaMaMaMaMaMaMaMaQaLaLaLaLacacacababababababababababababababababababababababacacacacabaaafaoaoaoaoafaoaoaoafaoaoaoafaaaaaaaaaa
aaaaaHaHaHaHaQaHaHaHaHaQaHaMaMaHaLaLaLaLacacacababababababababababababababababababababababacacacacabaaafaoaoaoaoafaoaoaoafaoaoaoafaaaaaaaaaa
aaaaaHaPaMaMaMaHbebfbgaMaHaHaHaHaaaaaaabacacacababababababababababababababababababababababacacacacabaaafaoaSaoaoaoaoaoaoaoaoaoaoafaaaaaaaaaa
aaaaaHaPaMaMaNaHbebfbgaMaQbhbiaHaaaaaaabacacacababababababababababababababababababababababacacacacabaaafaUayaoaoafaqayasafaoaoaoafaaaaaaaaaa
aaaaaHaPaMaMaNaHaMaMaMaMaHbhbhaHaaaaaaabacacacababababababababababababababababababababababacacacacabaaafaobjaoaoafaqayasafaoaoaoafaaaaaaaaaa
aaaaaHaMaPaPaMaHaZaZbabaaHbkblaHaaaaaaabacacacababababababababababababababababababababababacacacacabaaafafafafafafafafafafafafafafaaaaaaaaaa
aaaaaHaHaHaHaHaHaHaHaHaHaHaHaHaHaaaaaaabacacacababababababababababababababababababababababacacacacabaaaaaaaaaaaaaaaaaaaaaaaaaaaaaaaaaaaaaaaa
aaaaaaaaaaaaaaaaaaaaaaaaaaaaaaaaaaaaaaabacacacababababababababababababababababababababababacacacacabaaaaaaaaaaaaaaaaaaaaaaaaaaaaaaaaaaaaaaaa
aaaaaaaaaaaaaaaaaaaaaaaaaaaaaaaaaaaaaaabacacacababababababababababababababababababababababacacacacabaaaaaaaaaaaaaaaaaaaaaaaaaaaaaaaaaaaaaaaa
aaaaaaaaaaaaaaaaaaaaaaaaaaaaaaaaaaaaaaabacacacababababababababababababababababababababababacacacacabaaaaaaaaaaaaaaaaaaaaaaaaaaaaaaaaaaaaaaaa
aaaaaaaaaaaaaaaaaaaaaaaaaaaaaaaaaaaaaaabacacacababababababababababababababababababababababacacacacabaaaaaaaaaaaaaaaaaaaaaaaaaaaaaaaaaaaaaaaa
aaaaaaaaaaaaaaaaaaaaaaaaaaaaaaaaaaaaaaabacacacababababababababababababababababababababababacacacacabaaaaaaaaaaaaaaaaaaaaaaaaaaaaaaaaaaaaaaaa
aaaaaaaaaaaaaaaaaaaaaaaaaaaaaaaaaaaaaaabacacacababababababababababababababababababababababacacacacabaaaaaaaaaaaaaaaaaaaaaaaaaaaaaaaaaaaaaaaa
ababababababababababababababababababababacacacababababababababababababababababababababababacacacacababababababababababababababababababababab
acacacacacacacacacacacacacacacacacacacacacacacacacacacacacacacacacacacacacacacacacacacacacacacacacacacacacacacacacacacacacacacacacacacacacac
acacacacacacacacacacacacacacacacacacacacacacacacacacacacacacacacacacacacacacacacacacacacacacacacacacacacacacacacacacacacacacacacacacacacacac
acacacacacacacacacacacacacacacacacacacacacacacacacacacacacacacacacacacacacacacacacacacacacacacacacacacacacacacacacacacacacacacacacacacacacac
acacacacacacacacacacacacacacacacacacacacacacacacacacacacacacacacacacacacacacacacacacacacacacacacacacacacacacacacacacacacacacacacacacacacacac
abababababababababababababababababababababababababababababababababababababababababababababababababababababababababababababababababababababab
"}
