"a" = (/turf/snow/gravsnow,/area/space)
"b" = (/turf/simulated/floor/pavement,/area/space)
"c" = (/turf/simulated/floor/road,/area/space)
"d" = (/obj/structure/window/fence,/turf/snow/gravsnow,/area/space)
"e" = (/obj/structure/window/fence{dir = 8},/turf/snow/gravsnow,/area/space)
"f" = (/turf/simulated/wall/wood,/area/space)
"g" = (/obj/structure/window/fence{dir = 4},/turf/snow/gravsnow,/area/space)
"h" = (/turf/simulated/floor/wood,/area/space)
"i" = (/obj/structure/barricade,/turf/simulated/floor/wood,/area/space)
"j" = (/obj/structure/toilet,/turf/simulated/floor/tiled/white,/area/space)
"k" = (/turf/simulated/floor/tiled/white,/area/space)
"l" = (/obj/structure/bed,/obj/item/weapon/bedsheet,/turf/simulated/floor/wood,/area/space)
"m" = (/obj/structure/bed/chair/wood{dir = 4},/turf/simulated/floor/wood,/area/space)
"n" = (/obj/structure/table/standard,/turf/simulated/floor/wood,/area/space)
"o" = (/obj/structure/bed/chair/wood{dir = 8},/turf/simulated/floor/wood,/area/space)
"p" = (/obj/structure/bed/chair/wood{dir = 1},/turf/simulated/floor/wood,/area/space)
"q" = (/obj/structure/bed/chair/comfy,/turf/simulated/floor/wood,/area/space)
"r" = (/obj/structure/bed/chair/comfy{dir = 4},/turf/simulated/floor/wood,/area/space)
"s" = (/obj/structure/table/woodentable,/turf/simulated/floor/wood,/area/space)
"t" = (/obj/structure/bed/chair/comfy{dir = 1},/turf/simulated/floor/wood,/area/space)
"u" = (/obj/structure/window/fence{dir = 1},/turf/snow/gravsnow,/area/space)
"v" = (/obj/structure/bed,/obj/item/weapon/bedsheet/blue,/turf/simulated/floor/wood,/area/space)
"w" = (/obj/structure/table/standard,/obj/item/weapon/grenade/frag,/turf/simulated/floor/wood,/area/space)
"x" = (/turf/simulated/wall/concrete,/area/space)
"y" = (/obj/structure/table/steel,/turf/simulated/floor/fixed,/area/space)
"z" = (/turf/simulated/floor/fixed,/area/space)
"A" = (/obj/structure/table/steel,/turf/simulated/floor/wood,/area/space)
"B" = (/turf/simulated/floor/holofloor/tiled,/area/space)
"C" = (/obj/machinery/shower,/turf/simulated/floor/holofloor/tiled,/area/space)
"D" = (/obj/structure/toilet{dir = 1},/turf/simulated/floor/holofloor/tiled,/area/space)

(1,1,1) = {"
aaaaaaaaaaaaaaaaaaabaaabaaaaaaaaaaaaaaaaaaaabccccbaaaaaaaaaaaaaaaaaaaa
aaaaaaaaaaaaaaaaaaabcccbaaaaaaaaaaaaaaaaaaaabccccbaaaaaaaaaaaaaaaaaaaa
aaaaaaaaaaaaaaaaaaabcccbaaaaaaaaaaaaaaaaaaaabccccbaaaaaaaaaaaaaaaaaaaa
aaaaaaaaaaaaaaaaaaabcccbaaaaaaaaaaaaaaaaaaaabccccbaaaaaaaaaaaaaaaaaaaa
addddddddddddddddddbcccbaaaaaaaaaaaaaaaaaaaabccccbaaaaaaaaaaaaaaaaaaaa
aefffffaaaaaaaaaaagbcccbaaaaaaaaaaaaaaaaaaaabccccbaaaaaaaaaaaaaaaaaaaa
aefhhhfaaaaaaaaaaagbcccbaaaaaaaaaaaaaaaaaaaabccccbaaaaaaaaaaaaaaaaaaaa
aefhhhfaaaaaaaaaaagbcccbhhhhhhhhhhhhhhhhhhhhbccccbaaaaaaaaaaaaaaaaaaaa
aeffiffaaaaaaaaaaagbcccbhhhhhhhhhhhhhhhhhhhhbccccbaffffffffffffffaaaaa
aeaaaaaaaaaaaaaaaagbcccbhhhhhhhhhhhhhhhhhhhhbccccbafhhfhhhhhfjkkfaaaaa
aeaaaaaaaaaaaaaaaagbcccbhhhhhhhhhhhhhhhhhhhhbccccbafhhhhhhhhfkkkfaaaaa
aefffffffffffffffagbcccbhhhhhhhhhhhhhhhhhhhhbccccbaffhfffffffffhfaaaaa
aefhlhlfmnnohfhhfagbcccbhhhhhhhhhhhhhhhhhhhhbccccbafhhhhfhhhfhhhfaaaaa
aefhlhlfhpphhhhhfagbcccbhhhhhhhhhhhhhhhhhhhhbccccbafhhhhfhhhfhhhfaaaaa
aefhhhhhhhhhhfhhfaabcccbhhhhhhhhhhhhhhhhhhhhbccccbafhqhhhhhhhhhhfaaaaa
aefhlhlfhhhhhfhhhbbbcccbhhhhhhhhhhhhhhhhhhhhbccccbafrshhfmsofhhhfaaaaa
aefffffffffffffffbgbcccbhhhhhhhhhhhhhhhhhhhhbccccbafhthhfmsofhhhfaaaaa
aeaaaaaaaaaaaaaaaagbcccbhhhhhhhhhhhhhhhhhhhhbccccbaffffffffffffffaaaaa
aeaaaaaaaaaaaaaaaagbcccbhhhhhhhhhhhhhhhhhhhhbccccbaaaaaaaaaaaaaaaaaaaa
aeaaaaaaaaaaaaaaaagbcccbhhhhhhhhhhhhhhhhhhhhbccccbaaaaaaaaaaaaaaaaaaaa
aeaaaaaaaaaaaaaaaagbcccbhhhhhhhhhhhhhhhhhhhhbccccbaaaaaaaaaaaaaaaaaaaa
auuuuuuuuuuuuuuuuuubcccbhhhhhhhhhhhhhhhhhhhhbccccbaffffffffffffffaaaaa
aeaaaaaaaaaaaaaaaagbcccbhhhhhhhhhhhhhhhhhhhhbccccbafhhfhhhhhfjkkfaaaaa
aeaaaaaaaaaaaaaaaagbcccbhhhhhhhhhhhhhhhhhhhhbccccbafhhhhhhhhfkkkfaaaaa
aeffiffffffffffffagbcccbhhhhhhhhhhhhhhhhhhhhbccccbaffhfffffffffhfaaaaa
aefhhhfvvvfmwohhfagbcccbhhhhhhhhhhhhhhhhhhhhbccccbafhhhhfhhhfhhhfaaaaa
aefhhhfhhhhhphhhfagbcccbhhhhhhhhhhhhhhhhhhhhbccccbafhhhhfhhhfhhhfaaaaa
aefhhhfvvvfhhhhhhbbbcccbhhhhhhhhhhhhhhhhhhhhbccccbafhqhhhhhhhhhhfaaaaa
aefffffffffffffffagbcccbhhhhhhhhhhhhhhhhhhhhbccccbafrshhfmsofhhhfaaaaa
aeaaaaaaaaaaaaaaaagbcccbaaaaaaaaaaaaaaaaaaaabccccbafhthhfmsofhhhfaaaaa
aduuuuuuuuuuuuuuuuubcccbaaaaaaaaaaaaaaaaaaaabccccbaffffffffffffffaaaaa
aeaaaaaaaaaaaaaaaagbcccbaaaaaaaaaaaaaaaaaaaabccccbaaaaaaaaaaaaaaaaaaaa
aeaaaaaaaaaaaaaaaagbcccbbbbbbbbbbbbbbbbbbbbbbccccbaaaaaaaaaaaaaaaaaaaa
aeaaaaaaaaaaaaaaaagbcccbbbbbbbbbbbbbbbbbbbbbbccccbaaaaaaaaaaaaaaaaaaaa
aeaaaaaaaaaaaaaaaagbcccbbbbbbbbbbbbbbbbbbbbbbccccbaffffffffffffffaaaaa
aeffiffffffffffffagbcccbbbbbbbbbbbbbbbbbbbbbbccccbafhhfhhhhhfjkkfaaaaa
aefhhhhflllfmnnofagbcccbbbbbbbbbbbbbbbbbbbbbbccccbbfhhhhhhhhfkkkfaaaaa
aefhhhhflhhhhhhhfbbbcccbbbbbbbbbbbbbbbbbbbbbbccccbaffhfffffffffhfaaaaa
aefhhhhflllhhhhhhbbbcccbbbbbbbbbbbbbbbbbbbbbbccccbafhhhhfhhhfhhhfaaaaa
aefffffffffffffffbbbcccbbbbbbbbbbbbbbbbbbbbbbccccbafhhhhfhhhfhhhfaaaaa
auuuuuuuuuuuuuuuuuubcccbbbbbbbbbbbbbbbbbbbbbbccccbafhqhhhhhhhhhhfaaaaa
aaxxxxxxxxxxxxxxxaabcccbbbbbbbbbbbbbbbbbbbbbbccccbafrshhfmsofhhhfaaaaa
aaxyyyyyxzzzzzzzzaabcccbbbbbbbbbbbbbbbbbbbbbbccccbafhthhfmsofhhhfaaaaa
aaxyzzzzxzzzzzzzzaabcccbbbbbbbbbbbbbbbbbbbbbbccccbaffffffffffffffaaaaa
aaxyzzzzzzzzzzzzzaabcccbbbbbbbbbbbbbbbbbbbbbbccccbaaaaaaaaaaaaaaaaaaaa
aaxxxxxxxxxxxxxxxaabcccbbbbbbbbbbbbbbbbbbbbbbccccbaaaaaaaaaaaaaaaaaaaa
aaaaaaaaaaaaaaaaaaabcccbbbbbbbbbbbbbbbbbbbbbbccccbaaaaaaaaaaaaaaaaaaaa
aaffffffffffffffaaabcccbbbbbbbbbbbbbbbbbbbbbbccccbaffffffffffffffaaaaa
aafhhhhfhhhhfhhfaaabcccbbbbbbbbbbbbbbbbbbbbbbccccbafhhfhhhhhfjkkfaaaaa
aafhhhhfhhhhfhhfaaabcccbbbbbbbbbbbbbbbbbbbbbbccccbbfhhhhhhhhfkkkfaaaaa
aaffffiffffiffhfbbbbcccbbbbbbbbbbbbbbbbbbbbbbccccbaffhfffffffffhfaaaaa
aafhhhhhhhhhhhhhbbbbcccbbbbbbbbbbbbbbbbbbbbbbccccbafhhhhfhhhfhhhfaaaaa
aaffffhffffhfhhfbbbbcccbbbbbbbbbbbbbbbbbbbbbbccccbafhhhhfhhhfhhhfaaaaa
aaflhhhfmAohffffaaabcccbbbbbbbbbbbbbbbbbbbbbbccccbafhqhhhhhhhhhhfaaaaa
aaflhhhfmAohhBCfaaabcccbbbbbbbbbbbbbbbbbbbbbbccccbafrshhfmsofhhhfaaaaa
aafllllfhhhhfDBfaaabcccbbbbbbbbbbbbbbbbbbbbbbccccbafhthhfmsofhhhfaaaaa
aaffffffffffffffaaabcccbbbbbbbbbbbbbbbbbbbbbbccccbaffffffffffffffaaaaa
aaaaaaaaaaaaaaaaaaabcccbbbbbbbbbbbbbbbbbbbbbbccccbaaaaaaaaaaaaaaaaaaaa
aaaaaaaaaaaaaaaaaaabcccbbbbbbbbbbbbbbbbbbbbbbccccbaaaaaaaaaaaaaaaaaaaa
aaaaaaaaaaaaaaaaaaabcccbbbbbbbbbbbbbbbbbbbbbbccccbaaaaaaaaaaaaaaaaaaaa
aaaaaaaaaaaaaaaaaaabcccbbbbbbbbbbbbbbbbbbbbbbccccbaaaaaaaaaaaaaaaaaaaa
aaaaaaaaaaaaaaaaaaabcccbbbbbbbbbbbbbbbbbbbbbbccccbaaaaaaaaaaaaaaaaaaaa
aaaaaaaaaaaaaaaaaaabcccbbbbbbbbbbbbbbbbbbbbbbccccbaaaaaaaaaaaaaaaaaaaa
aaaaaaaaaaaaaaaaaaabcccbbbbbbbbbbbbbbbbbbbbbbccccbaaaaaaaaaaaaaaaaaaaa
bbbbbbbbbbbbbbbbbbbbcccbbbbbbbbbbbbbbbbbbbbbbccccbbbbbbbbbbbbbbbbbbbbb
cccccccccccccccccccccccccccccccccccccccccccccccccccccccccccccccccccccc
cccccccccccccccccccccccccccccccccccccccccccccccccccccccccccccccccccccc
cccccccccccccccccccccccccccccccccccccccccccccccccccccccccccccccccccccc
cccccccccccccccccccccccccccccccccccccccccccccccccccccccccccccccccccccc
bbbbbbbbbbbbbbbbbbbbbbbbbbbbbbbbbbbbbbbbbbbbbbbbbbbbbbbbbbbbbbbbbbbbbb
"}
